abdik	abdik	1
abi	abi	1
abiler	abi-ler	1
abin	abi-n	3
abini	abi-n-i	1
abinin	abi-nin	1
abinle	abi-n-le	1
abisi	abi-si	1
abisinin	abi-si-nin	1
abla	abla	10
ablalar	abla-lar	1
ablan	abla-n	5
ablanın	abla-nın	3
ablasının	abla-sı-nın	1
ablaya	abla-ya	2
ablayla	abla-yla	1
ablayı	abla-yı	1
ablayım	abla-yım	1
acaba	acaba	37
acıdı	acı-dı	13
acıdın	acı-dı-n	1
acık	acık	3
acıkmadı	acık-ma-dı	2
acıktı	acık-tı	5
acıkınca	acık-ınca	2
acımış	acı-mış	5
acımıştır	acı-mış-tır	1
acıttı	acı-t-tı	1
acıtırlar	acı-t-ır-lar	1
acıyor	acı-yor	7
adam	adam	15
adama	adam-a	1
adamlar	adam-lar	2
adamları	adam-lar-ı	1
adamı	adam-ı	2
adamın	adam-ın	6
adaya	aday-a	1
ademe	adem-e	1
ademin	adem-in	1
adları	ad-lar-ı	1
adı	ad-ı	12
adım	adım	1
adın	ad-ın	1
adına	ad-ı-na	1
adını	ad-ı-nı	2
aferim	aferim	4
aferin	aferin	8
ah	ah	23
aha	ah-a	4
ahbaplık	ahbap-lık	1
akbank	ak+bank	3
aklım	akl-ım	1
akrabanız	akraba-nız	1
akıyor	ak-ıyor	2
akşam	akşam	19
akşamki	akşam-ki	1
akşamları	akşam-lar-ı	20
al	al	60
alabilirsin	al-abil-ir-sin	4
alacak	al-acak	11
alacağım	al-acağ-ım	2
alalı	ala-lı	1
alalım	ala-lı-m	12
alamazsın	al-a-ma-z-sın	1
alayım	ala-yım	2
alda	al-da	1
aldı	al-dı	45
aldık	al-dı-k	7
aldılar	al-dı-lar	1
aldım	al-dı-m	7
aldın	al-dı-n	6
aldınız	al-dı-nız	9
aldırma	al-dır-ma	1
aldırıyorlar	aldır-ıyor-lar	1
aleti	alet-i	1
aletlere	alet-ler-e	1
aletleri	alet-ler-i	2
aletlerin	alet-ler-in	1
aletlerini	alet-ler-i-ni	1
alev	alev	19
algül	algül	1
aliyi	ali-yi	1
allah	allah	30
alma	al-ma	1
almaya	al-ma-ya	1
almayacağım	al-ma-yacağ-ım	1
almayalım	al-ma-ya-lı-m	1
almazsak	al-ma-z-sa-k	1
almıyorlar	al-mı-yor-lar	1
almış	al-mış	12
almışlar	al-mış-lar	1
almıştı	al-mış-tı	1
alo	alo	1
alp	alp	6
alpay	alpay	3
alpayı	alpay-ı	1
alpe	alp-e	1
alper	alper	9
alsana	al-sana	1
alsın	al-sın	5
altı	altı	3
altın	altın	2
altına	alt-ı-na	8
altında	alt-ı-nda	8
altından	alt-ı-ndan	2
alçıya	alçı-ya	1
alın	alın	2
alınmaz	al-ın-ma-z	2
alıp	al-ıp	4
alır	al-ır	3
alırsan	al-ır-sa-n	1
alırsınız	al-ır-sınız	1
alırım	al-ır-ım	2
alırız	al-ır-ız	1
alıyor	al-ıyor	9
alıyormuş	al-ıyor-muş	1
alıyorsun	al-ıyor-sun	3
alıyorsunuz	al-ıyor-sunuz	3
alıyorum	al-ıyor-um	3
alıyoruz	al-ıyor-uz	8
alıyım	al-ı-yım	1
alış	al-ış	2
ama	ama	129
aman	aman	8
amca	amca	13
amcalar	amca-lar	2
amcalarının	amca-lar-ı-nın	1
amcan	amca-n	5
amcanı	amca-n-ı	1
amcanın	amca-nın	1
amcanıza	amca-nız-a	1
amcaya	amca-ya	4
amcayla	amca-yla	1
amcayı	amca-yı	1
amerikada	amerika-da	1
amin	amin	1
ana	ana	1
anacım	anac-ım	2
anaokuluna	anaokulu-n-a	2
ancak	ancak	1
anda	an-da	2
ankaraya	ankara-ya	1
anladım	anla-dı-m	1
anladın	anla-dı-n	2
anlamadım	anla-ma-dı-m	7
anlamıyorum	anla-mı-yor-um	4
anlat	anla-t	169
anlatabilir	anla-t-abil-ir	1
anlatacak	anla-t-acak	2
anlatacaksın	anlat-acak-sın	1
anlatalım	anla-t-a-lı-m	1
anlatayım	anla-t-a-yım	1
anlatma	anla-t-ma	1
anlatmadın	anlat-ma-dı-n	1
anlatmayacaksın	anlat-ma-yacak-sın	1
anlatmaz	anlat-ma-z	1
anlatmıyor	anlat-mı-yor	1
anlatsan	anlat-sa-n	1
anlatsana	anla-t-sana	32
anlattı	anla-t-tı	3
anlatır	anla-t-ır	11
anlatırsın	anlat-ır-sın	3
anlatıyor	anla-t-ıyor	3
anlatıyordun	anlat-ıyor-du-n	2
anlatıyorum	anlat-ıyor-um	1
anlaşılan	anlaş-ıl-an	1
anne	anne	72
anneanne	anne+anne	15
anneannen	anne+anne-n	10
anneannende	anne+anne-n-de	1
anneannene	anne+anne-n-e	1
anneanneni	anne+anne-n-i	3
anneannenin	anne+anne-nin	2
anneanneye	anne+anne-ye	1
anneanneyi	anne+anne-yi	4
annecilik	anne-ci-lik	2
anneciğim	anne-ciğ-im	1
anneciğin	anne-ciğ-in	1
anneler	anne-ler	2
anneleri	anne-ler-i	1
annelerinden	anne-ler-i-nden	1
annelerine	anne-ler-i-ne	1
annem	anne-m	4
annemin	anne-m-in	1
annen	anne-n	173
annene	anne-n-e	10
anneni	anne-n-i	12
annenin	anne-nin	13
anneniz	anne-niz	1
annenle	anne-n-le	7
annenler	anne-n-ler	4
annesi	anne-si	15
annesini	anne-si-ni	3
annesinin	anne-si-nin	2
annesiyle	anne-si-yle	1
anneye	anne-ye	2
anneyi	anne-yi	7
anneyle	anne-yle	3
antika	antika	2
apartmanın	apartman-ın	1
ara	ara	1
araba	araba	40
arabalar	araba-lar	19
arabalara	araba-lar-a	1
arabaları	araba-lar-ı	16
arabalarım	araba-lar-ım	1
arabaların	araba-lar-ın	1
arabam	araba-m	1
arabamızın	araba-mız-ın	1
arabanın	araba-nın	1
arabanız	araban-ız	2
arabası	araba-sı	3
arabasının	araba-sı-nın	1
arabaya	araba-ya	5
arabayla	araba-yla	2
arabayı	araba-yı	18
arada	ara-da	6
aradın	ara-dı-n	2
aramayacak	ara-ma-yacak	1
arar	ara-r	1
arasın	ara-sın	2
arasında	ara-sı-nda	2
aratalım	ara-t-a-lı-m	1
arayacak	ara-yacak	1
arif	arif	2
arka	arka	2
arkada	arka-da	1
arkadaki	arka-da-ki	1
arkadan	arka-dan	3
arkadaş	arkadaş	4
arkadaşlarla	arkadaş-lar-la	2
arkadaşları	arkadaş-lar-ı	2
arkadaşların	arkadaş-lar-ın	19
arkadaşlarınla	arkadaş-lar-ın-la	1
arkadaşı	arkadaş-ı	1
arkadaşın	arkadaş-ın	18
arkadaşını	arkadaş-ı-nı	1
arkadaşının	arkadaş-ı-nın	1
arkadaşınız	arkadaş-ınız	1
arkamda	arka-m-da	1
arkanda	arka-n-da	2
arkasına	arka-sı-na	2
arkasını	arka-sı-nı	1
arkaya	arka-ya	1
arslan	arslan	1
artist	artist	1
artistlerden	artist-ler-den	1
artık	artık	32
arı	arı	2
arıyor	arı-yor	2
arıyorsun	arı-yor-sun	5
arıyorum	arı-yor-um	2
asalım	asal-ım	1
askerler	asker-ler	2
aslan	aslan	3
aslanlar	aslan-lar	2
aslanlarla	aslan-lar-la	1
aslanın	aslan-ın	3
aslında	aslında	1
asılı	ası-lı	4
at	at	13
ata	ata	13
atacak	at-acak	1
atacan	atacan	2
atacağım	at-acağ-ım	1
atam	ata-m	1
atamı	ata-m-ı	1
atamıyorum	ata-mı-yor-um	1
atar	at-ar	17
atarsın	at-ar-sın	32
atasel	atasel	1
atatürkü	ata+türk-ü	2
atayım	at-a-yım	2
ateş	ateş	2
atla	at-la	2
atladık	atla-dı-k	1
atladığımız	atla-dığ-ımız	1
atlamıyor	atla-mı-yor	1
atlar	at-lar	9
atlayacaksın	atla-yacak-sın	1
atlıyor	atlı-yor	2
atlıyorsun	atlı-yor-sun	1
atma	at-ma	2
atmadın	at-ma-dı-n	1
atmıyorsun	at-mı-yor-sun	1
atmış	at-mış	4
attılar	at-tı-lar	3
attın	at-tı-n	10
atçılık	at-çı-lık	1
atı	at-ı	2
atılmaz	atıl-ma-z	1
atın	at-ın	3
atıyor	at-ıyor	10
atıyorlar	at-ıyor-lar	1
atıyorlardı	at-ıyor-lar-dı	1
atıyorsun	at-ıyor-sun	7
atıyorsunuz	at-ıyor-sunuz	1
avcılık	avcı-lık	1
ay	ay	2
ayakkabılar	ayak+kabı-lar	1
ayakkabıları	ayak+kabı-lar-ı	1
ayakla	ayak-la	1
ayakları	ayak-ları	5
ayaklarım	ayak-lar-ım	1
ayakların	ayak-lar-ın	1
ayaklarından	ayak-lar-ı-ndan	1
ayaklarının	ayak-lar-ı-nın	1
ayala	ayala	3
ayalanın	ayala-nın	2
ayalayı	ayala-yı	1
ayağa	ayağ-a	4
ayağı	ayağ-ı	3
ayağına	ayağ-ı-na	3
ayağınla	ayağ-ın-la	2
ayağını	ayağ-ı-nı	2
aydede	aydede	1
aydınlıkta	aydın-lık-ta	1
ayfer	ayfer	1
aykutla	aykut-la	1
aykutlar	aykut-lar	6
aykutlara	aykut-lar-a	2
ayla	ayla	4
aylin	aylin	4
ayni	ayni	1
aynur	aynur	2
aynı	aynı	1
aynısı	aynı-sı	1
aynısından	aynı-sı-ndan	1
ayol	ayol	2
ayrıyeten	ayrıyeten	1
aysel	aysel	1
ayı	ay-ı	3
ayılar	ayı-lar	1
ayın	ay-ın	1
ayının	ay-ı-nın	2
ayıp	ayıp	8
ayır	ayır	3
ayısı	ayı-sı	1
ayşe	ayşe	10
ayşegül	ayşegül	8
ayşegülü	ayşegül-ü	2
az	az	1
azıcık	azıcık	15
aç	aç	9
açabilirsin	aç-abil-ir-sin	1
açacak	aç-acak	1
açacam	aç-a-ca-m	2
açalım	aç-a-lı-m	2
açar	aç-ar	1
açarlar	aç-ar-lar	1
açarsan	aç-ar-sa-n	1
açarım	aç-ar-ım	3
açayım	aç-a-yım	4
açma	açma	1
açmadım	aç-ma-dı-m	1
açmadınız	aç-ma-dı-nız	1
açmak	aç-mak	1
açmamış	aç-ma-mış	1
açmayacağım	aç-ma-yacağ-ım	1
açmayalım	aç-ma-ya-lı-m	1
açmış	aç-mış	4
açmışlar	aç-mış-lar	1
açsana	aç-sana	1
açtı	aç-tı	3
açtık	aç-tı-k	2
açtım	aç-tı-m	1
açıcam	açı-ca-m	1
açık	açık	8
açıldı	aç-ıl-dı	3
açılmadı	aç-ıl-ma-dı	1
açılmaz	aç-ıl-ma-z	1
açılmazsa	aç-ıl-ma-z-sa	1
açılmıyor	aç-ıl-mı-yor	3
açılmış	aç-ıl-mış	1
açılsın	aç-ıl-sın	1
açılır	aç-ıl-ır	4
açılıyor	aç-ıl-ıyor	1
açıyor	aç-ıyor	3
açıyorlar	aç-ıyor-lar	1
açıyorsun	aç-ıyor-sun	1
açıyım	açı-yım	1
ağabey	ağabey	1
ağabeyin	ağabey-in	2
ağabeyinden	ağabey-i-nden	1
ağaca	ağac-a	1
ağalday	ağalday	1
ağaç	ağaç	2
ağaçlar	ağaç-lar	4
ağaçlara	ağaç-lar-a	1
ağaçlı	ağaç-lı	1
ağaçta	ağaç-ta	1
ağbi	ağbi	3
ağbin	ağbi-n	8
ağbinin	ağbi-nin	2
ağbinle	ağbi-n-le	4
ağladı	ağla-dı	2
ağladın	ağla-dı-n	2
ağlamıyor	ağla-mı-yor	1
ağlar	ağ-lar	3
ağlayacak	ağla-yacak	1
ağlayacağım	ağla-yacağ-ım	2
ağlayan	ağla-yan	1
ağlayayım	ağla-ya-yım	2
ağlıyor	ağlı-yor	10
ağlıyordu	ağlı-yor-du	1
ağlıyorsun	ağlı-yor-sun	1
ağzı	ağz-ı	2
ağzım	ağz-ım	1
ağzıma	ağz-ım-a	1
ağzına	ağz-ı-na	6
ağzında	ağz-ı-nda	1
ağzından	ağz-ı-ndan	1
ağzını	ağz-ı-nı	4
ağır	ağır	3
ağızlarını	ağız-lar-ı-nı	1
aşağı	aşağı	4
aşağıda	aşağı-da	5
aşağıdaki	aşağı-da-ki	3
aşağıya	aşağı-ya	4
aşk	aşk	1
baba	baba	68
babaanne	baba+anne	4
babaannen	baba+anne-n	7
babaannenden	baba+anne-n-den	2
babaannene	baba+anne-n-e	1
babaanneni	baba+anne-n-i	1
babaannenin	baba+anne-nin	3
babaannesi	baba+anne-si	1
babaanneye	baba+anne-ye	2
babaanneyi	baba+anne-yi	1
babacık	baba-cık	2
babacığın	baba-cığ-ın	1
babaları	baba-lar-ı	1
babam	baba-m	1
baban	baba-n	97
babana	baba-n-a	4
babandan	baba-n-dan	3
babanla	baba-n-la	5
babanı	baba-n-ı	16
babanın	baba-nın	14
babanınki	baba-nın-ki	1
babası	baba-sı	14
babasını	baba-sı-nı	1
babaya	baba-ya	2
babayı	baba-yı	3
baca	baca	5
bacakları	bacak-lar-ı	3
bacaklarından	bacak-lar-ı-ndan	1
bacaklarını	bacak-ları-nı	4
bacası	baca-sı	2
bacağı	bacağ-ı	1
bacağına	bacağ-ı-na	1
badana	badana	1
bahsediyorduk	bahsed-iyor-du-k	1
bahsediyorlar	bahsed-iyor-lar	1
bahset	bahset	6
bahsetsene	bahset-sene	1
bahçe	bahçe	5
bahçede	bahçe-de	6
bahçesi	bahçe-si	4
bahçesinde	bahçe-si-nde	2
bahçesine	bahçe-si-ne	4
bahçesini	bahçe-si-ni	1
bahçeye	bahçe-ye	3
bak	bak	262
bakacaksın	bak-acak-sın	2
bakalım	bak-a-lı-m	211
bakarlar	bak-ar-lar	1
bakayım	bak-a-yım	80
bakkaldan	bakkal-dan	1
baklava	baklava	1
bakma	bak-ma	1
bakmadım	bak-ma-dı-m	1
bakmadın	bak-ma-dı-n	1
bakmak	bak-mak	2
bakmayacakmışsın	bak-ma-yacak-mış-sın	1
bakmayalım	bak-ma-ya-lı-m	1
bakmış	bak-mış	1
baksan	bak-sa-n	2
baksana	bak-sana	4
baksın	bak-sın	2
baktı	bak-tı	1
baktılar	bak-tı-lar	1
baktım	bak-tı-m	3
bakın	bakın	1
bakınca	bak-ınca	2
bakıyor	bak-ıyor	3
bakıyorum	bak-ıyor-um	1
bal	bal	2
balkon	balkon	1
balkona	balkon-a	1
balon	balon	8
balonu	balon-u	4
balonun	balo-nun	1
balık	balık	57
balıklar	balık-lar	53
balıklara	balık-lar-a	2
balıklarla	balık-lar-la	3
balıkları	balık-lar-ı	14
balıkların	balık-lar-ın	4
balıkçı	balık-çı	1
balığa	balığ-a	4
balığı	balığ-ı	15
balığım	balığ-ım	1
balığımı	balığ-ım-ı	1
balığın	balığ-ın	23
bana	ban-a	236
bant	bant	5
bantın	bant-ın	1
banyo	banyo	1
banyoda	banyo-da	2
banyosu	banyo-su	2
banyoya	banyo-ya	1
barbarosa	barbaros-a	1
bardak	bardak	1
bardakla	bardak-la	1
bardaklar	bardak-lar	1
bardaktan	bardak-tan	1
bardağın	bardağ-ın	1
bardağını	bardağ-ı-nı	1
bari	bari	7
basacak	bas-acak	1
basar	bas-ar	2
basarsan	bas-ar-sa-n	1
baston	baston	2
bastım	bas-tı-m	1
bastın	bastı-n	1
bastır	bas-tır	1
bastırma	bas-tır-ma	1
bastırmaya	bas-tır-ma-ya	1
bastığın	bastığ-ın	1
basık	basık	1
basınca	basınc-a	1
basıyor	bas-ıyor	1
batar	batar	1
batmış	bat-mış	1
batonlar	baton-lar	1
battaniye	battaniye	1
battaniyeyi	battaniye-yi	2
batırıyor	bat-ır-ıyor	3
bavul	bavul	3
bavullar	bavul-lar	2
bayağı	bayağı	4
baylarda	bay-lar-da	1
bayram	bayram	3
bayıldım	bayıl-dı-m	1
bazan	bazan	4
bazen	bazen	80
bazı	bazı	1
bağlamadım	bağla-ma-dı-m	1
bağlı	bağ-lı	1
bağsız	bağ-sız	1
bağıracağız	bağır-acağ-ız	2
bağırdı	bağır-dı	3
bağırır	bağır-ır	5
bağırırlar	bağır-ır-lar	1
bağırıyor	bağır-ıyor	5
bağırıyorlar	bağır-ıyor-lar	1
bağırıyorsun	bağır-ıyor-sun	3
başka	başka	293
başkalarını	başka-ları-nı	2
başkalarının	başka-ları-nın	1
başkası	başka-sı	2
başkasını	başka-sı-nı	1
başlasana	başla-sana	1
baştan	baş-tan	1
başı	baş-ı	2
başıma	baş-ım-a	1
başımı	baş-ım-ı	1
başımıza	baş-ımız-a	1
başın	baş-ın	1
başına	baş-ı-na	6
başında	baş-ı-nda	1
başından	baş-ı-ndan	1
başınıza	baş-ınız-a	2
bebek	bebek	37
bebekle	bebek-le	2
bebekler	bebek-ler	4
bebeklerden	bebek-ler-den	1
bebeklere	bebek-ler-e	1
bebekleri	bebek-ler-i	5
bebeklerin	bebek-ler-in	4
bebeklerinle	bebek-ler-in-le	1
bebekte	bebek-te	2
bebeğe	bebeğ-e	1
bebeği	bebeğ-i	14
bebeğin	bebeğ-in	12
bebeğini	bebeğ-i-ni	3
bekledin	bekle-di-n	1
bekler	bekle-r	1
bekliyor	bekli-yor	1
bekliyorlar	bekli-yor-lar	1
bekliyorum	bekli-yor-um	1
bekçi	bekçi	3
belki	belki	10
ben	ben	243
bende	bend-e	3
benden	bende-n	1
beni	ben-i	14
benim	ben-im	78
benimi	ben-im-i	1
benimki	ben-im-ki	1
benimkiler	ben-im-ki-ler	1
benle	ben-le	5
benzedi	benze-di	1
benzemiyor	benze-mi-yor	1
benzer	benzer	2
benzin	benzin	1
benziyor	benzi-yor	9
beraber	beraber	55
berbere	berber-e	3
bey	bey	4
beyaz	beyaz	2
beyza	beyza	2
bez	bez	1
bezi	bez-i	1
bezle	bez-le	1
beğendiler	beğen-di-ler	2
beğendim	beğen-di-m	10
beğendin	beğen-di-n	9
beğeniyor	beğen-iyor	3
beğenmedim	beğen-me-di-m	3
beğenmiyorsun	beğen-mi-yor-sun	1
beş	beş	5
biber	biber	1
biberi	biber-i	1
bile	bile	1
biletçi	bilet-çi	3
biletçiyi	bilet-çi-yi	1
bilezik	bilezik	2
bileziği	bileziğ-i	2
bileziğin	bileziğ-in	3
bilir	bil-ir	3
bilirsin	bil-ir-sin	2
biliyor	bil-iyor	123
biliyordun	bil-iyor-du-n	1
biliyorsan	bil-iyor-sa-n	3
biliyorsun	bil-iyor-sun	17
biliyorum	bil-iyor-um	7
bilmem	bil-me-m	30
bilmez	bil-me-z	1
bilmiyor	bil-mi-yor	9
bilmiyordum	bil-mi-yor-du-m	1
bilmiyormuş	bil-mi-yor-muş	1
bilmiyorsun	bil-mi-yor-sun	12
bilmiyorum	bil-mi-yor-um	11
bilmiş	bil-miş	1
bin	bin	1
binbir	binbir	1
bindi	bindi	6
bindik	bin-di-k	9
bindiler	bindi-ler	2
bindin	bindi-n	8
bindiniz	bin-di-niz	2
bindinizde	bindi-niz-de	1
bindir	bin-dir	2
bindiririm	bin-dir-ir-im	1
binebilir	bin-ebil-ir	6
binebilirler	bin-ebil-ir-ler	1
binecek	bin-ecek	2
bineceksin	bin-ecek-sin	4
binemez	bin-e-me-z	2
binemiyor	bin-e-mi-yor	3
biner	bin-er	2
binersin	bin-er-sin	1
binip	bin-ip	1
biniyor	bin-iyor	2
biniyorsunuz	bin-iyor-sunuz	3
biniyorum	bin-iyor-um	1
binmek	bin-mek	1
binmeyecek	bin-me-yecek	1
binmiyor	bin-mi-yor	1
binmiyorum	bin-mi-yor-um	1
binsin	bin-sin	4
bir	bir	303
biraz	biraz	53
birazcık	birazcık	10
birbirinize	birbir-iniz-e	1
birden	birden	2
birer	bir-er	1
birgün	bir+gün	4
biri	bir-i	1
birileri	birileri	1
birini	bir-i-ni	1
birisi	birisi	4
birsenler	bir+sen-ler	1
birşey	birşey	85
birşeyi	birşey-i	4
birşeyimiz	birşey-im-iz	1
birşeyler	birşey-ler	8
bisiklet	bisiklet	1
bisiklete	bisiklet-e	2
bisikleti	bisiklet-i	1
bisikletini	bisiklet-i-ni	2
bisikletle	bisiklet-le	1
bisikletler	bisiklet-ler	1
biskuit	biskuit	1
biskuitler	biskuit-ler	1
bisküvi	bisküvi	2
bisküviler	bisküvi-ler	1
bisküvitlerini	bisküvit-ler-i-ni	1
bismillah	bismillah	1
bitecek	bit-ecek	1
bitince	bit-ince	2
bitir	bit-ir	1
bitirelim	bit-ir-e-li-m	1
bitirelimde	bit-ir-e-li-m-de	1
bitirmiş	bit-ir-miş	1
bitmiş	bit-miş	1
bitsin	bit-sin	1
bitsinde	bit-si-n-de	1
bitti	bit-ti	3
biz	biz	40
bize	biz-e	17
bizim	biz-im	13
bizimki	biz-im-ki	1
biçim	biçim	2
bluzu	bluz-u	1
bom	bom	3
bon	bon	2
boncuk	boncuk	9
boncuklara	boncuk-lar-a	1
boncuklardan	boncuk-lar-dan	1
boncukları	boncuk-lar-ı	7
boncuğu	boncuğ-u	2
borazanını	borazan-ı-nı	1
bostana	bostan-a	2
boya	boya	9
boyadın	boya-dı-n	1
boyaların	boya-lar-ın	5
boyalarını	boya-lar-ı-nı	1
boyalı	boya-lı	2
boyamak	boya-mak	4
boyamıyor	boya-mı-yor	3
boyamışsın	boya-mış-sın	1
boyanacak	boya-n-acak	1
boyandı	boya-n-dı	1
boyanmaz	boya-n-ma-z	4
boyanır	boya-n-ır	6
boyar	boyar	1
boyasıyla	boya-sı-yla	2
boyayalım	boya-ya-lı-m	2
boynu	boyn-u	1
boynumda	boyn-um-da	1
boynumdan	boyn-um-dan	2
boynuna	boyn-u-na	4
boyum	boy-um	1
boyun	boyun	1
boyundan	boy-u-ndan	1
boyunu	boy-u-nu	1
boyuyor	boyu-yor	19
boyuyorsun	boyu-yor-sun	6
bozarım	boz-ar-ım	1
bozdu	boz-du	1
bozdun	boz-du-n	2
bozuk	bozuk	3
bozuldu	boz-ul-du	2
bozulmuş	boz-ul-muş	4
bozulmuştu	boz-ul-muş-tu	1
bozuluyor	boz-ul-uyor	2
bozuyorum	boz-uyor-um	2
boğazlıyana	boğazlıyan-a	1
boğazlıyanda	boğazlıyan-da	1
boğazından	boğaz-ı-ndan	1
boş	boş	7
boşalt	boşal-t	1
bravo	bravo	2
bremen	bremen	1
bu	bu	607
bugün	bugün	41
bugünlerde	bugün-ler-de	1
buharlı	buhar-lı	1
bukalemun	bukalemun	2
bul	bul	4
bulabilir	bul-abil-ir	1
bulabiliyor	bul-abil-iyor	1
bulamadım	bul-a-ma-dı-m	1
bulamadın	bul-a-ma-dı-n	3
bulamayız	bul-a-ma-yız	1
bulamaz	bula-ma-z	1
bulayım	bul-a-yım	1
bulaşık	bulaşık	2
bulaşığı	bulaşığ-ı	1
buldum	bul-du-m	3
buldun	bul-du-n	3
buluyum	bu-lu-yum	1
buluştuk	buluş-tu-k	1
buna	bu-na	16
bunda	bu-nda	2
bundan	bu-ndan	1
bunla	bu-nla	10
bunlar	bu-nlar	93
bunlara	bu-nlar-a	1
bunlarla	bu-nlar-la	2
bunları	bu-nlar-ı	24
bunların	bu-nlar-ın	5
bunsuz	bun-suz	1
bunu	bu-nu	85
bunun	bu-nun	17
bununla	bu-nunla	4
burada	bura-da	25
buradaki	bura-da-ki	1
buradan	bura-dan	1
buradayken	bura-da-yken	1
buradayım	bura-da-yım	1
buraları	bura-lar-ı	2
burası	bura-sı	21
burasında	bur-ası-n-da	2
burasını	bura-sı-nı	2
burasıydı	bur-ası-ydı	1
buraya	bura-ya	44
burayı	bura-yı	2
burda	bur-da	73
burdaki	bur-da-ki	2
burdan	bur-dan	16
burnu	burn-u	2
burnun	burn-un	2
burnuna	burn-u-na	1
burnunu	burn-u-nu	2
burçak	burçak	125
burçakçığım	burçak-çığ-ım	10
burçakı	burçak-ı	1
burçakın	burçak-ın	1
böbrek	böbrek	1
böcek	böcek	3
böceği	böceğ-i	1
böyle	böyle	79
bülent	bülent	2
bütün	bütün	3
büyüdün	büyü-dü-n	1
büyük	büyük	40
büyüktü	büyük-tü	2
büyüyecek	büyü-yecek	2
büyüyünce	büyü-yünce	3
büyüğüm	büyüğ-üm	1
bıktın	bık-tı-n	1
bırak	bırak	5
bırakacağız	bırak-acağ-ız	1
bırakalım	bırak-a-lı-m	1
bırakamam	bırak-a-ma-m	1
bırakmayacağım	bırak-ma-yacağ-ım	1
bırakmış	bırak-mış	2
bırakmışsın	bırak-mış-sın	1
bıraktı	bırak-tı	1
bırakıp	bırak-ıp	1
bıyık	bıyık	1
bıyıkları	bıyık-lar-ı	1
bıyığı	bıyığ-ı	1
bıçakla	bıçak-la	2
caddede	cadde-de	2
caddelerde	cadde-ler-de	1
cadı	cadı	2
cam	cam	4
camlar	cam-lar	1
camı	cam-ı	1
camın	cam-ın	1
canan	canan	1
canana	canan-a	1
cananın	canan-ın	1
cancağızım	cancağız-ım	1
canlı	canlı	2
canım	can-ım	139
canın	can-ın	1
ceket	ceket	1
ceketini	ceket-i-ni	1
cemile	cemile	4
cemoya	cemo-ya	1
ceryan	ceryan	3
cevap	cevap	10
ceviz	ceviz	3
ceylan	ceylan	1
ceylanların	ceylan-lar-ın	1
cezveye	cezve-ye	1
cici	cici	14
cicisin	cici-sin	1
cins	cins	3
civ	civ	2
coca	coca	1
cola	cola	1
cumartesi	cumartesi	1
cüce	cüce	1
cüneyt	cüneyt	3
cünkü	c-ün-kü	1
da	da	192
dadı	dadı	1
dadın	dadı-n	2
dadısız	dadı-sız	1
daha	daha	69
dahaki	daha-ki	1
dairede	daire-de	2
daireden	daire-den	1
dairesine	daire-si-ne	1
daireye	daire-ye	2
dakika	dakika	7
daktiloda	daktilo-da	3
daktiloyla	daktilo-yla	1
dalların	dal-lar-ın	2
dama	dama	1
damat	damat	1
dana	dana	2
danalar	dana-lar	2
dandini	dandini	5
dans	dans	6
davul	davul	1
davulun	davul-un	1
davulunu	davul-u-nu	1
dayın	dayı-n	2
dayının	dayı-nın	1
dağ	dağ	1
dağda	dağ-da	1
dağılmasın	dağıl-ma-sın	1
dağılıyor	dağıl-ıyor	1
dağınık	dağınık	1
dağıtmadan	dağıt-ma-dan	1
de	de	180
dede	dede	8
deden	dede-n	11
dedene	dede-n-e	2
dedeni	dede-n-i	3
dedenin	dede-nin	1
dedeye	dede-ye	1
dedeyi	dede-yi	1
dedi	de-di	14
dediler	de-di-ler	1
dedim	de-di-m	4
dedin	de-di-n	16
dediniz	de-di-niz	2
dediğimi	de-diğ-im-i	1
dediğini	de-diğ-i-ni	2
defa	defa	1
defasında	defa-sı-nda	2
defteri	defter-i	2
defterim	defter-im	1
delik	delik	1
deme	dem-e	2
demedin	de-me-di-n	2
demek	demek	9
demeyecektin	de-me-yecek-ti-n	2
demin	demin	8
deminki	demin-ki	2
demiyorum	de-mi-yor-um	3
demiş	de-miş	3
demiştin	de-miş-ti-n	2
dene	dene	2
deneyelim	dene-ye-li-m	1
denir	de-n-ir	2
deniyor	de-n-iyor	1
deniz	deniz	11
denizde	deniz-de	17
denize	deniz-e	23
denizhan	deniz+han	1
denizhanla	deniz+han-la	2
denizhanı	deniz+han-ı	2
denizi	deniz-i	2
denizin	deniz-in	1
denizlerde	deniz-ler-de	1
denmez	de-n-me-z	1
der	de-r	3
derler	de-r-ler	3
derlerse	derle-r-se	1
dersi	ders-i	1
dersin	ders-in	8
dert	dert	2
derya	derya	1
dese	de-se	1
desene	desen-e	1
deseydin	de-se-ydi-n	1
desin	de-sin	2
devamlı	devam-lı	1
deve	deve	1
deveye	deve-ye	1
deveyi	deve-yi	1
devrildiler	devril-di-ler	1
devrilir	devril-ir	1
deyince	deyi-n-ce	1
değil	değil	255
değildi	değil-di	1
değiller	değil-ler	1
değilsin	değil-sin	1
değişik	değişik	1
değiştir	değ-iş-tir	1
değiştirebilirsin	değiş-tir-ebil-ir-sin	1
değnek	değnek	1
değneği	değneğ-i	1
dibine	dib-i-ne	1
dikiyor	dik-iyor	3
dikiş	dik-iş	1
dikkat	dikkat	2
dikkatli	dikkat-li	1
dikmiş	dik-miş	1
dikti	dik-ti	2
diktiler	dik-ti-ler	1
diktirdi	dik-tir-di	1
diktirmişler	dik-tir-miş-ler	1
dinle	din-le	2
dinledik	dinle-di-k	1
dinledin	dinle-di-n	3
dinlemiyormuş	dinle-mi-yor-muş	1
dinlemiyorsun	dinle-mi-yor-sun	1
dinleteceğim	dinle-t-eceğ-im	1
dinleyeceğiz	dinle-yeceğ-iz	1
dinleyelim	dinle-ye-li-m	1
dinliyor	dinli-yor	3
direkler	direk-ler	1
direksiyon	direksiyon	3
divanın	divan-ın	2
diye	diye	33
diyebilir	di-yebil-ir	1
diyecektin	di-yecek-ti-n	5
diyor	di-yor	24
diyordum	di-yor-du-m	1
diyordun	di-yor-du-n	2
diyorlar	di-yor-lar	2
diyorlarmış	di-yor-lar-mış	1
diyormuş	di-yor-muş	2
diyorsun	di-yor-sun	12
diyorum	di-yor-um	5
diz	diz	4
dizdin	diz-di-n	1
diziyor	diz-iyor	1
diziyorsun	diz-iyor-sun	2
dişine	diş-i-ne	2
dişleri	diş-ler-i	2
dişlerin	diş-ler-in	2
dişleriyle	diş-ler-i-yle	1
dişçide	diş-çi-de	1
dişçiye	diş-çi-ye	1
doksandört	doksandört	1
doktor	doktor	5
doktora	doktor-a	4
dokunmak	dokun-mak	1
dokuz	dokuz	1
dolabın	dolab-ın	1
dolacak	dol-acak	1
doldur	dol-dur	2
doldurursun	dol-dur-ur-sun	1
dolduruyorsun	dol-dur-uyor-sun	1
dolmuşa	dolmuş-a	2
dolu	dolu	2
doluyor	dol-uyor	1
domuz	domuz	8
domuza	domuz-a	1
domuzu	domuz-u	1
domuzun	domuz-un	2
dondurma	dondurma	1
dondurmacı	dondurma-cı	1
dondurmacıyı	dondurma-cı-yı	1
dondurmayı	dondurma-yı	2
donuna	don-u-na	1
donunu	don-u-nu	2
doyuruyorsun	doyur-uyor-sun	1
doğru	doğru	5
doğrusunu	doğru-su-nu	4
doğum	doğum	9
doğuracak	doğ-ur-acak	2
dudaklarına	dudak-lar-ı-na	1
dudağına	dudağ-ı-na	2
dur	dur	35
durabilirler	dur-abil-ir-ler	1
duracak	dur-acak	2
duramaz	dur-a-ma-z	1
duramıyor	dur-a-mı-yor	1
durdu	dur-du	3
durdukları	dur-duk-ları	1
durdurayım	dur-dur-a-yım	1
durdurursun	dur-dur-ur-sun	1
durmam	dur-ma-m	1
durmaz	dur-ma-z	1
durmuyor	dur-mu-yor	2
durmuş	dur-muş	1
dursun	dur-sun	21
dursunlar	dur-sunlar	1
durup	dur-up	1
durur	dur-ur	3
dururken	dur-ur-ken	1
duruyor	dur-uyor	15
duruyorsun	dur-uyor-sun	1
duvara	duvar-a	1
duvarda	duvar-da	2
duvardakileri	duvar-da-ki-leri	1
duyarsa	duy-ar-sa	1
duydum	duy-du-m	1
duydun	duy-du-n	4
duymadım	duy-ma-dı-m	3
duymuyorum	duy-mu-yor-um	4
duysun	duy-sun	1
duyuyorum	duy-uyor-um	2
dvora	dvora	1
döküyor	dök-üyor	1
dön	dön	2
döner	döner	1
dönmek	dön-mek	1
dönmem	dönme-m	2
dönmüyor	dön-mü-yor	1
dönmüş	dön-müş	1
dönmüştür	dön-müş-tür	1
dönüyor	dön-üyor	2
dördünüz	dörd-ünüz	1
dört	dört	5
dövdü	döv-dü	3
döveceksin	döv-ecek-sin	1
döven	döv-en	1
döver	döv-er	3
dövmüyor	döv-mü-yor	1
dövmüş	döv-müş	1
dövsün	döv-sün	1
dövüyor	döv-üyor	11
dövüyorlar	döv-üyor-lar	1
dövüyormuş	döv-üyor-muş	1
düdük	düdük	3
dükkan	dükkan	1
dükkanda	dükkan-da	3
dükkandan	dükkan-dan	1
dümdüz	dümdüz	2
dün	dün	41
dünkü	dün-kü	1
düpedüz	düpedüz	1
dürüst	dürüst	3
düz	düz	2
düzeldi	düzel-di	1
düzelt	düzel-t	1
düzelteyim	düzelt-e-yim	2
düzgün	düzgün	5
düğme	düğme	1
düğün	düğün	1
düşecek	düş-ecek	1
düşeceksin	düş-ecek-sin	1
düşer	düş-er	3
düşerler	düş-er-ler	1
düşmeden	düş-me-den	1
düşmemiş	düş-me-miş	1
düşmesin	düş-me-sin	3
düşmez	düş-me-z	1
düşmüyor	düş-mü-yor	2
düşmüyorsun	düş-mü-yor-sun	1
düşmüş	düş-müş	6
düştü	düş-tü	13
düştün	düş-tü-n	4
düşün	düşün	1
düşünürüz	düşünür-üz	1
düşürdü	düş-ür-dü	1
düşürüyorsun	düş-ür-üyor-sun	1
düşüyor	düş-üyor	4
dışarda	dışar-da	45
dışardan	dışar-dan	2
dışarı	dışarı	15
dışarıda	dışarı-da	19
dışarıya	dışarı-ya	29
ebecilik	ebe-ci-lik	1
eczacılar	ecza-cı-lar	1
edecekler	ed-ecek-ler	1
edeceksin	ed-ecek-sin	2
edeceğiz	ed-eceğ-iz	1
edelim	ede-li-m	1
eden	ed-en	1
edepsizlik	edep-siz-lik	4
eder	ed-er	4
ederim	ed-er-im	3
edersen	ed-er-se-n	1
edeyim	ed-e-yim	1
edince	ed-ince	2
ediyor	ed-iyor	12
ediyorlar	ed-iyor-lar	4
ediyorsun	ed-iyor-sun	5
ediyorsunuz	ed-iyor-sunuz	1
ediyoruz	ed-iyor-uz	1
efendi	efendi	1
efendim	efendi-m	49
ekmek	ekmek	3
eksik	eksik	2
elbet	elbet	1
elbise	elbise	4
elbiselerini	elbise-ler-i-ni	3
elbisen	elbise-n	3
elbisene	elbise-n-e	1
elbiseni	elbise-n-i	1
elbisesi	elbise-si	2
elbisesine	elbise-si-ne	1
elbisesini	elbise-si-ni	1
elbiseyi	elbise-yi	2
elektrikler	elektrik-ler	1
elele	elele	1
eli	el-i	1
elif	elif	7
elifçiğim	elif-çiğ-im	1
elim	elim	1
elimde	el-im-de	5
elimdekini	el-im-de-ki-n-i	1
elime	el-im-e	1
elimi	el-im-i	2
elin	el-in	2
elinde	el-i-nde	5
elindekilerle	el-i-nde-ki-ler-le	1
eline	el-i-ne	5
elini	el-i-ni	3
elinle	el-in-le	2
eliyle	el-i-yle	2
ellemesinler	elle-me-sinler	1
ellerimin	el-ler-im-in	1
ellerini	el-ler-i-ni	1
ellerinle	el-ler-in-le	2
elma	elma	2
elvan	elvan	3
emebilir	em-ebil-ir	1
emirgana	emirgan-a	1
emirganda	emirgan-da	1
emiyor	em-iyor	2
emsin	em-sin	1
en	en	18
ender	ender	1
enderi	ender-i	1
enderle	ender-le	1
engin	engin	2
engini	engin-i	1
enginin	engin-in	1
enginle	engin-le	1
enişten	enişte-n	7
eniştene	enişte-n-e	1
enişteni	enişte-n-i	1
enişteyi	enişte-yi	1
ensene	ense-n-e	1
enteresan	enteresan	1
ercüment	ercüment	2
erel	erel	9
erelcim	erel-ci-m	2
erele	erel-e	2
erelim	erel-im	1
erelin	erel-in	1
erenle	eren-le	1
erikle	erik-le	1
erkek	erkek	5
erkeklerle	erkek-ler-le	1
erkekçe	erkek-çe	1
erken	erken	10
erkenden	erken-den	2
erkeğe	erkeğ-e	1
esas	esas	1
eski	eski	6
eskici	eski-ci	2
eskiden	eskiden	2
eskiler	eski-ler	1
eskiyor	eski-yor	1
et	et	20
etek	etek	1
etekliğini	etek-liğ-i-ni	1
eti	et-i	4
etilerde	eti-ler-de	1
etini	et-i-ni	1
etli	et-li	2
etme	et-me	1
etmedi	et-me-di	1
etmedin	et-me-di-n	1
etmek	et-mek	2
etmiyor	et-mi-yor	1
etmiyorsun	et-mi-yor-sun	1
etmiyorum	et-mi-yor-um	1
etmişim	et-miş-im	1
etrafına	etraf-ı-na	3
etrafında	etraf-ı-nda	1
etrafındakiler	etraf-ı-nda-ki-ler	1
etsek	et-se-k	1
etsene	et-sene	4
etsin	et-sin	4
ettik	et-ti-k	1
ettikten	et-tik-ten	1
ettim	et-ti-m	1
ettin	et-ti-n	2
ev	ev	20
evcilik	evcilik	5
evde	ev-de	105
evdekileri	ev-de-ki-leri	1
evden	ev-den	4
evdeydi	ev-de-ydi	1
eve	ev-e	29
evet	evet	99
evi	ev-i	15
evimize	ev-imiz-e	1
evin	ev-in	43
evinde	ev-i-nde	4
evine	ev-i-ne	7
evini	ev-i-ni	1
eviniz	evin-iz	4
evinizde	ev-iniz-de	2
evinize	ev-iniz-e	1
evinizi	ev-iniz-i	2
evinizin	ev-iniz-in	1
eviymiş	ev-i-ymiş	3
evladım	evlad-ım	3
evle	ev-le	4
evler	ev-ler	2
evleri	ev-ler-i	5
evlerinin	ev-ler-i-nin	1
evvela	evvela	8
eyvah	eyvah	3
eyüp	eyüp	1
ezdi	ez-di	1
eğer	eğer	2
eğilir	eğil-ir	1
eğlendin	eğlen-di-n	1
eşek	eşek	5
eşeğe	eşeğ-e	2
eşeği	eşeğ-i	1
eşeğim	eşeğ-im	1
fakat	fakat	2
falan	falan	12
fare	fare	1
fareler	fare-ler	1
farelerin	fare-ler-in	1
faruk	faruk	1
fasulye	fasulye	1
fatma	fatma	1
fatoşla	fatoş-la	1
faytona	fayton-a	1
faytonda	fayton-da	1
fazla	fazla	1
felan	felan	2
fena	fena	4
fenerbahçeliyim	fener+bahçe-li-yim	1
fenerde	fener-de	1
feneri	fener-i	2
fevkalade	fevkalade	1
fevzi	fevzi	1
fikir	fikir	1
fil	fil	1
filan	filan	10
filim	fil-im	3
filimde	fil-im-de	1
filimdi	fil-im-di	1
filimi	fil-im-i	1
filler	fil-ler	1
film	film	3
filmde	film-de	1
filmi	film-i	3
filmin	film-in	1
filmleri	film-ler-i	1
fincan	fincan	3
fincana	fincan-a	1
fincanı	fincan-ı	1
fincanına	fincan-ı-na	1
fiş	fiş	1
fuat	fuat	5
funda	funda	9
fundanın	funda-nın	4
fundaya	funda-ya	1
fundayla	funda-yla	6
futbol	futbol	6
füsun	füsun	3
füsuncum	füsun-cu-m	2
füsuncuğum	füsun-cuğ-um	5
fırlatıyor	fırla-t-ıyor	1
fırçayla	fırça-yla	1
fırın	fırın	6
fırınla	fırınla	1
fıstık	fıstık	3
gagalıyorlar	gagalı-yor-lar	2
gagasını	gaga-sı-nı	1
galatasaraylıymış	galata+saray-lı-ymış	1
galiba	galiba	15
garaj	garaj	2
garaja	garaj-a	1
garajda	garaj-da	1
garajınız	garaj-ınız	2
garip	garip	1
gazete	gazete	16
gazetesi	gazete-si	3
gazeteyi	gazete-yi	2
gazinoya	gazino-ya	1
gazoz	gazoz	1
gece	gece	31
geceleri	gece-ler-i	5
geceleyin	geceleyin	3
gecelik	gece-lik	1
gel	gel	75
geldi	gel-di	47
geldik	gel-di-k	3
geldiler	gel-di-ler	3
geldim	gel-di-m	3
geldin	gel-di-n	4
geldiniz	gel-di-niz	6
geldiği	gel-diğ-i	1
gelecek	gelecek	6
gelecekler	gelecek-ler	2
gelecekmiş	gelecek-miş	1
gelecem	gel-e-ce-m	1
geleceğim	gel-eceğ-im	1
gelemedin	gel-e-me-di-n	1
gelemez	gel-e-me-z	1
gelen	gel-en	4
geleyim	gel-e-yim	5
gelin	gelin	9
gelince	gel-ince	9
gelip	gel-ip	1
gelir	gelir	11
gelirim	gel-ir-im	1
gelirken	gelir-ken	2
gelirler	gelir-ler	1
gelirse	gel-ir-se	1
gelirsen	gel-ir-se-n	1
geliyor	gel-iyor	71
geliyorlar	gel-iyor-lar	1
geliyorum	gel-iyor-um	1
gelme	gel-me	1
gelmedi	gel-me-di	9
gelmediğim	gel-me-diğ-im	1
gelmemiş	gel-me-miş	1
gelmesin	gel-me-sin	1
gelmeyecek	gel-me-yecek	1
gelmeyeceksin	gel-me-yecek-sin	1
gelmeyeceğim	gel-me-yeceğ-im	1
gelmiyor	gel-mi-yor	5
gelmiş	gel-miş	23
gelmişler	gel-miş-ler	1
gelmişti	gel-miş-ti	1
gelmiştin	gel-miş-ti-n	2
gelse	gel-se	1
gelsene	gel-sene	2
gelsin	gel-sin	8
gelsinler	gel-sinler	1
gemi	gemi	4
gemide	gemi-de	3
gemiler	gemi-ler	1
gemilerden	gemi-ler-den	1
geminin	gemi-nin	6
gemiye	gemi-ye	5
gemiyi	gemi-yi	1
genceye	gen-ce-ye	1
gene	gen-e	9
gerek	gerek	1
geri	geri	1
getir	getir	19
getirdi	getir-di	31
getirdiklerini	getir-dik-leri-ni	1
getirdiler	getir-di-ler	1
getirdim	getir-di-m	1
getirdiği	getir-diğ-i	2
getirecek	getir-ecek	3
getirecem	getir-e-ce-m	1
getirecen	getir-e-ce-n	1
getirelim	getir-e-li-m	1
getireyim	getir-e-yim	4
getiriyor	getir-iyor	15
getiriyorsunuz	getir-iyor-sunuz	1
getirmedi	getir-me-di	1
getirmeyeyim	getir-me-ye-yim	1
getirmiş	getir-miş	2
getirmişti	getir-miş-ti	1
getirsem	getir-se-m	1
getirsene	getir-sene	3
geyik	geyik	2
geyikle	geyik-le	1
geyiği	geyiğ-i	1
gezeceksin	gez-ecek-sin	1
gezmeye	gez-me-ye	11
gezmiyor	gez-mi-yor	1
geç	geç	7
geçecek	geç-ecek	2
geçen	geç-en	6
geçende	geç-e-n-de	1
geçer	geç-er	3
geçiriyorsun	geçir-iyor-sun	1
geçiriyorsunuz	geç-ir-iyor-sunuz	1
geçiyor	geç-iyor	10
geçsin	geç-sin	1
geçti	geç-ti	7
gibi	gibi	20
gidebilirler	gid-ebil-ir-ler	1
gidecek	gid-ecek	12
gidecekler	gid-ecek-ler	3
gidecekmiş	gid-ecek-miş	1
gideceksin	gid-ecek-sin	18
gideceksiniz	gid-ecek-siniz	2
gidecem	gid-e-ce-m	2
gidecen	gid-e-ce-n	1
gideceğiz	gid-eceğ-iz	1
gideli	gid-eli	1
gidelim	gid-e-li-m	6
gidemedim	gid-e-me-di-m	1
gidemezsin	gid-e-me-z-sin	2
gider	gid-er	19
giderim	gid-er-im	1
giderken	gider-ken	10
giderler	gider-ler	4
gidersek	gid-er-se-k	2
gidersin	gid-er-sin	20
gideyim	gid-e-yim	4
gidin	gid-in	1
gidince	gid-ince	9
gidip	gid-ip	4
gidiyor	gid-iyor	77
gidiyordu	gid-iyor-du	3
gidiyorduk	gid-iyor-du-k	1
gidiyordun	gid-iyor-du-n	2
gidiyorlar	gid-iyor-lar	7
gidiyorlarmış	gid-iyor-lar-mış	1
gidiyormuş	gid-iyor-muş	6
gidiyorsun	gid-iyor-sun	33
gidiyorsunuz	gid-iyor-sunuz	7
gidiyorum	gid-iyor-um	2
gidiyoruz	gid-iyor-uz	9
girdi	gir-di	6
girdiler	gir-di-ler	2
girdim	gir-di-m	1
girdin	gir-di-n	3
girebilir	gir-ebil-ir	2
girecek	gir-ecek	2
giremezsin	gir-e-me-z-sin	1
girer	gir-er	5
girerse	gir-er-se	1
giriyor	gir-iyor	7
giriyorlar	gir-iyor-lar	2
girmedi	gir-me-di	1
girmek	gir-mek	1
girmeyecek	gir-me-yecek	1
girmez	gir-me-z	4
girmiyor	gir-mi-yor	2
girmiş	gir-miş	3
girsin	gir-sin	3
girsinler	gir-sinler	4
git	git	9
gitme	git-me	1
gitmedik	git-me-di-k	1
gitmediler	git-me-di-ler	1
gitmedin	git-me-di-n	3
gitmediniz	git-me-di-niz	2
gitmek	git-mek	6
gitmem	git-me-m	1
gitmesin	git-me-sin	1
gitmeyeceksin	git-me-yecek-sin	1
gitmeyi	git-me-yi	2
gitmez	git-me-z	4
gitmezse	git-me-z-se	1
gitmiyor	git-mi-yor	9
gitmiyorsun	git-mi-yor-sun	2
gitmiyorum	git-mi-yor-um	1
gitmiş	git-miş	8
gitmişler	git-miş-ler	2
gitmişlerdi	git-miş-ler-di	2
gitmiştin	git-miş-ti-n	2
gitsin	git-sin	7
gitsinler	git-sinler	4
gitti	git-ti	49
gittik	git-ti-k	16
gittikten	git-tik-ten	1
gittiler	git-ti-ler	6
gittim	git-ti-m	2
gittin	git-ti-n	23
gittiniz	git-ti-niz	27
gittiysen	git-ti-yse-n	1
gittiğin	git-tiğ-in	1
gittiğinde	git-tiğ-i-nde	1
gittiğini	git-tiğ-i-ni	1
giydi	giy-di	1
giydin	giy-di-n	5
giydiniz	giy-di-niz	2
giydirdi	giy-dir-di	1
giydireyim	giy-dir-e-yim	2
giyerdin	giy-er-di-n	7
giyip	giy-ip	1
giyiyor	giy-iyor	6
giyiyorlar	giy-iyor-lar	1
giyiyorsun	giy-iyor-sun	1
giymemiş	giy-me-miş	1
giymez	giy-me-z	1
giymiş	giy-miş	2
goril	goril	1
grip	grip	1
gökçen	gökçen	1
gömlek	gömlek	1
gönderiyor	gönder-iyor	2
göndermiyorum	gönder-mi-yor-um	2
gör	gör	1
gördüm	gör-dü-m	7
gördün	gör-dü-n	62
gördünüz	gör-dü-nüz	1
gördüğün	gör-düğ-ün	1
görebilir	gör-ebil-ir	2
görelim	gör-e-li-m	3
göremiyorsun	gör-e-mi-yor-sun	1
göreyim	gör-e-yim	8
görmedi	gör-me-di	1
görmedik	gör-me-di-k	1
görmedim	gör-me-di-m	6
görmedin	gör-me-di-n	6
görmek	gör-mek	4
görmesek	gör-me-se-k	1
görmeye	gör-me-ye	3
görmeyeli	gör-me-ye-li	5
görmüyorsun	gör-mü-yor-sun	1
görmüyorum	gör-mü-yor-um	4
görmüş	gör-müş	1
görmüşsün	gör-müş-sün	2
görmüştün	gör-müş-tü-n	2
görsün	gör-sün	2
görünce	gör-ünce	2
görünüyor	görün-üyor	4
görürler	gör-ür-ler	1
görürse	gör-ür-se	1
görürsün	gör-ür-sün	4
görüyor	gör-üyor	15
görüyorlar	gör-üyor-lar	1
görüyorsun	gör-üyor-sun	14
görüyorum	gör-üyor-um	8
göster	göster	33
gösterdi	göster-di	2
gösterdiler	göster-di-ler	1
gösterecek	göster-ecek	2
göstereceğim	göster-eceğ-im	1
göstereyim	göster-e-yim	3
gösterir	göster-ir	1
gösteriyorlar	göster-iyor-lar	1
göstermedin	göster-me-di-n	1
göstermiyorsun	göster-mi-yor-sun	1
göstersene	göster-sene	3
götür	götür	3
götürdü	götür-dü	6
götürdüler	götür-dü-ler	3
götürdüm	götür-dü-m	1
götürdün	götür-dü-n	2
götürecek	götür-ecek	10
götüreceksin	götür-ecek-sin	1
götüreceksiniz	götür-ecek-siniz	1
götürelim	götür-e-li-m	3
götüreyim	götür-e-yim	1
götürmedi	götür-me-di	1
götürmüyor	götür-mü-yor	2
götürmüşlerdi	götür-müş-ler-di	1
götürsün	götür-sün	2
götürünce	götür-ünce	1
götürür	götür-ür	1
götürürüz	götür-ür-üz	1
götürüyor	götür-üyor	11
götürüyorduk	götür-üyor-du-k	1
götürüyorsun	götür-üyor-sun	2
götürüyorum	götür-üyor-um	1
göz	göz	3
gözleri	göz-ler-i	5
gözlerim	göz-ler-im	2
gözlerimi	göz-ler-im-i	1
gözlerin	göz-ler-in	1
gözlerine	göz-ler-i-ne	1
gözlerini	göz-ler-i-ni	2
gözlük	gözlük	3
gözlüğü	gözlüğ-ü	2
gözlüğüm	gözlüğ-üm	1
gözü	göz-ü	2
gözüm	göz-üm	1
gözüme	göz-üm-e	1
gözümü	göz-üm-ü	1
gözün	göz-ün	1
gözünde	göz-ü-nde	1
gözüne	göz-ü-ne	3
gözünü	göz-ü-nü	4
gözünün	göz-ü-nün	2
güle	gül-e	6
gülebilir	gül-ebil-ir	1
gülhane	gülhane	1
güller	gül-ler	1
güllerimiz	gül-ler-imiz	1
güllühanların	güllühan-lar-ın	1
gülmesini	gül-me-si-ni	1
gülsün	gül-sün	1
gülün	gül-ün	1
gün	gün	7
gündüz	gündüz	17
güney	güney	1
güneş	güneş	4
güneşin	güneş-in	2
güneşlensin	güneş-len-sin	1
günlerde	gün-ler-de	4
günleri	gün-ler-i	1
günü	gün-ü	2
günün	gün-ün	4
gününde	gün-ü-nde	3
güreş	güreş	2
gürol	gürol	1
gürültü	gürültü	1
güvercin	güvercin	1
güzel	güzel	151
güzelcene	güzel-ce-n-e	1
güzeldir	güzel-dir	1
güzelim	güzelim	3
güzelmiş	güzel-miş	9
güzelmişim	güzel-miş-im	1
haber	haber	2
habire	habire	1
hacı	hacı	1
hadi	hadi	59
hadisi	hadis-i	1
hakan	hakan	2
hakana	hakan-a	1
hakanı	hakan-ı	1
hakiki	hakiki	1
hakkında	hakk-ı-nda	1
hala	hala	2
halada	hala-da	1
halalara	hala-lar-a	1
halan	hala-n	13
halana	hala-n-a	1
halanı	hala-n-ı	2
halanın	hala-nın	1
halaya	hala-ya	1
halbuki	halbuki	1
hali	hal-i	1
halin	hal-in	1
halı	halı	2
halısı	halı-sı	1
halıyı	halı-yı	4
ham	ham	2
hamdiyi	hamdi-yi	1
hamsi	hamsi	4
hamsiyi	hamsi-yi	2
han	han	2
hangi	hangi	51
hangileri	hangi-leri	1
hangisi	hangi-si	39
hangisinde	hangi-si-nde	2
hangisine	hangi-si-ne	4
hangisini	hangi-si-ni	17
hangisinin	hangi-si-nin	1
hani	hani	54
hanım	hanım	5
hanıma	hanım-a	1
hanımı	hanım-ı	1
hap	hap	7
hareketsiz	hareket-siz	1
harfi	harf-i	1
hasan	hasan	1
hasta	hasta	2
hastalandı	hasta-lan-dı	1
hastalanmadın	hasta-lan-ma-dı-n	1
hastalanmış	hasta-lan-mış	3
hastalığı	hastalığ-ı	1
hastanede	hastane-de	1
hastaneye	hastane-ye	1
hastaydı	has-ta-ydı	1
hastaydın	has-ta-ydı-n	1
hastayım	hasta-yım	1
haticenin	hatice-nin	2
hatırlamıyor	hatırla-mı-yor	2
hatırlarsın	hatırla-r-sın	1
hatırlıyor	hatırlı-yor	10
hav	hav	11
hava	hava	3
havada	hava-da	2
havasını	hava-sı-nı	1
havaya	hava-ya	1
havlar	havla-r	3
havlu	havlu	1
havluyu	havlu-yu	1
havuz	havuz	2
havuza	havuz-a	3
havuzu	havuz-u	2
havı	hav-ı	1
hayat	hayat	2
hayatım	hayat-ım	1
haydi	haydi	24
hayvan	hayvan	10
hayvanat	hayvanat	4
hayvanlar	hayvan-lar	7
hayvanlarla	hayvan-lar-la	5
hayvanları	hayvan-lar-ı	14
hayvanlarımı	hayvan-lar-ım-ı	1
hayvanların	hayvan-lar-ın	2
hayvansız	hayvan-sız	1
hayvanı	hayvan-ı	3
hayvanımı	hayvan-ım-ı	1
hayır	hayır	44
hazırlandınız	hazırla-n-dı-nız	1
helikopter	helikopter	2
helva	helva	1
helvası	helva-sı	1
hem	hem	8
hemen	hemen	4
hep	hep	10
hepimize	hep-imiz-e	1
hepiniz	hep-in-iz	1
hepsi	hep-si	5
hepsini	hep-si-ni	8
her	her	10
herbie	herbie	2
herbieyi	herbie-yi	1
hergün	hergün	10
herhalde	herhalde	17
herhangi	herhangi	1
herkes	herkes	2
herşey	herşey	2
herşeyi	herşey-i	1
heykel	heykel	1
hikaye	hikaye	17
hikayede	hikaye-de	1
hikayeler	hikaye-ler	1
hikayesi	hikaye-si	4
hikayesini	hikaye-si-ni	1
hikayeyi	hikaye-yi	1
hipopotam	hipopotam	1
hizmetçi	hizmetçi	1
hiç	hiç	113
hiçbir	hiçbir	1
hiçbirşey	hiçbirşey	6
hiçkimse	hiçkimse	2
hocaya	hoca-ya	1
horoz	horoz	2
horozlar	horoz-lar	1
horozum	horoz-um	1
hoş	hoş	2
hoşuna	hoş-u-na	2
huysuzluk	huy-suz-luk	2
hörgüç	hörgüç	1
hürrem	hürrem	1
hık	hık	1
hırkalıyı	hırka-lı-yı	1
hırkan	hırka-n	1
hızlı	hız-lı	9
hızın	hız-ın	2
ibik	ibik	2
ibiği	ibiğ-i	1
ibre	ibre	1
ihsan	ihsan	1
iki	iki	17
ikimiz	iki-miz	1
ikinizi	iki-niz-i	1
ikisi	iki-si	2
ikisini	iki-si-ni	1
ilacı	ilac-ı	3
ilahi	ilahi	1
ilaç	ilaç	5
ile	ile	2
ilhan	ilhan	2
ilkin	ilkin	2
in	in	5
inanmıyor	inan-mı-yor	1
inanmıyorsun	inan-mı-yor-sun	2
incitmez	incit-me-z	1
indik	in-di-k	2
indirdim	in-dir-di-m	2
indiriyor	in-dir-iyor	1
indiriyordu	in-dir-iyor-du	1
indiriyorlar	in-dir-iyor-lar	1
ineceksin	in-ecek-sin	1
inek	inek	4
inekle	inekle	1
inekler	inek-ler	6
ineklerden	inek-ler-den	2
inekten	inek-ten	1
inememiş	in-e-me-miş	1
inemiyor	in-e-mi-yor	1
inerken	in-er-ken	2
ineğe	ineğ-e	1
ineğin	ineğ-in	3
ingilizce	ingiliz-ce	1
inince	in-ince	1
iniyorsunuz	in-iyor-sunuz	1
inmiyor	in-mi-yor	1
insan	insan	2
insanlar	insan-lar	11
insanlardan	insan-lar-dan	1
insanı	insan-ı	2
insin	in-sin	1
ip	ip	1
is	is	2
isim	isim	2
isimleri	isim-ler-i	4
isimlerini	isim-ler-i-ni	2
iskelesine	iskele-si-ne	2
ismail	ismail	1
ismaille	ismail-le	1
ismi	ism-i	36
ismim	ism-im	2
ismin	ism-in	1
ismini	ism-i-ni	3
istanbulda	istanbul-da	2
istedi	iste-di	2
istediklerini	iste-dik-leri-ni	1
istediğini	iste-diğ-i-ni	2
istemesinler	iste-me-sinler	1
istemiyor	iste-mi-yor	3
istemiyorsun	iste-mi-yor-sun	1
istemiyorum	iste-mi-yor-um	3
istemiştin	iste-miş-ti-n	2
ister	ister	19
isterim	iste-r-im	1
isterlerse	iste-r-ler-se	1
istersen	iste-r-se-n	29
istersin	iste-r-sin	3
isteyince	iste-yince	1
istirahat	istirahat	1
istiyor	isti-yor	15
istiyorlar	isti-yor-lar	2
istiyorsan	isti-yor-sa-n	3
istiyorsun	isti-yor-sun	37
istiyorum	isti-yor-um	6
it	it	1
itfaiye	itfaiye	1
itfaiyeciler	itfaiye-ci-ler	1
itiyor	it-iyor	20
itti	it-ti	26
iyi	iyi	19
iyice	iyi-ce	1
iyicene	iyicene	1
iyileşti	iyi-leş-ti	1
iyileştin	iyi-leş-ti-n	1
iyisi	iyi-si	4
iyiyim	iyi-yim	1
içe	iç-e	1
içebilir	iç-ebil-ir	1
içecek	iç-ecek	1
içecekmiş	içecek-miş	1
içeceğim	iç-eceğ-im	1
içeceğiz	iç-eceğ-iz	1
içemez	iç-e-me-z	1
içer	iç-er	81
içerde	içer-de	1
içerdeki	içer-de-ki	1
içerdekiler	içer-de-ki-ler	1
içerden	içer-den	1
içeri	içeri	4
içeride	içeri-de	1
içerken	iç-er-ken	1
içerler	içerle-r	17
içersin	içer-sin	9
içersine	iç-er-si-n-e	2
içi	iç-i	2
için	için	47
içinde	iç-i-nde	41
içinden	iç-i-nden	3
içine	iç-i-ne	46
içir	iç-ir	1
içirmeyelim	iç-ir-me-ye-li-m	1
içiyor	iç-iyor	19
içiyorlar	iç-iyor-lar	4
içiyorsun	iç-iyor-sun	14
içmek	iç-mek	1
içmeseydin	iç-me-se-ydi-n	2
içmesini	iç-me-si-ni	1
içmez	iç-me-z	5
içmezler	iç-me-z-ler	6
içmiyor	iç-mi-yor	1
içse	iç-se	1
içsin	iç-sin	2
içtim	iç-ti-m	1
içtin	iç-ti-n	9
iğne	iğne	1
iş	iş	13
işaret	işaret	3
işareti	işaret-i	1
işaretleri	işaret-ler-i	1
işaretlerle	işaret-ler-le	1
işe	iş-e	12
işi	iş-i	8
işim	iş-im	1
işimizi	iş-imiz-i	1
işler	iş-ler	2
işleri	iş-ler-i	3
işte	işte	72
işıl	işıl	5
işıla	işıl-a	1
işılcığım	işıl-cığ-ım	2
işılla	işıl-la	3
jet	jet	1
jipini	jip-i-ni	1
kabuğu	kabuğ-u	3
kabuğunu	kabuğ-u-nu	1
kabın	kab-ın	1
kadar	kadar	22
kadarını	kadar-ı-nı	2
kadir	kadir	5
kadirin	kadir-in	1
kadirle	kadir-le	3
kadıköy	kadıköy	2
kadın	kadın	5
kadına	kadın-a	1
kafan	kafa-n	1
kahvaltı	kahvaltı	4
kahvaltıda	kahvaltı-da	1
kahve	kahve	5
kaka	kaka	5
kalabalık	kalabalık	1
kalacaksın	kal-acak-sın	1
kalacan	kal-a-ca-n	1
kaldım	kal-dı-m	2
kaldınız	kal-dı-nız	3
kaldırabilir	kaldır-abil-ir	1
kaldıracam	kal-dır-a-ca-m	1
kaldıralım	kal-dır-a-lı-m	5
kaldırayım	kaldır-a-yım	4
kaldırdı	kaldır-dı	3
kaldırdık	kaldır-dı-k	1
kaldırdın	kaldır-dı-n	3
kaldırmış	kaldır-mış	2
kaldırıp	kaldır-ıp	2
kaldırırsın	kaldır-ır-sın	1
kaldırırım	kaldır-ır-ım	1
kaldırıyorlar	kaldır-ıyor-lar	2
kaldırıyorsun	kaldır-ıyor-sun	1
kaldırıyorum	kaldır-ıyor-um	1
kale	kale	2
kaleci	kaleci	1
kalem	kalem	14
kalemi	kale-m-i	3
kalemim	kalem-im	1
kalemin	kalem-in	3
kalemle	kalem-le	20
kalemlerin	kalem-ler-in	2
kalemsiz	kalem-siz	1
kalk	kalk	2
kalkacakta	kalk-acak-ta	1
kalkarlar	kalk-ar-lar	1
kalkmıyor	kalk-mı-yor	2
kalkmış	kalk-mış	2
kalktı	kalk-tı	1
kalktım	kalk-tı-m	1
kalktın	kalk-tı-n	1
kalktınız	kalk-tı-nız	1
kalkınca	kalk-ınca	6
kalkıyor	kalk-ıyor	3
kalkıyorsun	kalk-ıyor-sun	2
kalkıyorsunuz	kalk-ıyor-sunuz	2
kalkıyoruz	kalk-ıyor-uz	1
kalmadı	kal-ma-dı	1
kalmamış	kal-ma-mış	1
kalmış	kal-mış	4
kaloriferler	kalorifer-ler	1
kalıp	kalıp	3
kalır	kal-ır	1
kalırsa	kal-ır-sa	4
kalıyorlar	kal-ıyor-lar	1
kalıyorsun	kal-ıyor-sun	1
kamyon	kamyon	10
kamyonda	kamyon-da	1
kamyonu	kamyon-u	4
kamyonun	kamyon-un	2
kanadı	kanad-ı	4
kanat	kanat	2
kanatla	kanat-la	1
kanatları	kanat-lar-ı	17
kanatların	kanat-lar-ın	1
kanatlarını	kanat-lar-ı-nı	3
kanayacak	kana-yacak	1
kapa	kap-a	4
kapadın	kapa-dı-n	1
kapalı	kapalı	2
kapaman	kapama-n	1
kapamazsa	kapa-ma-z-sa	2
kapanır	kapan-ır	1
kapanıyor	kapan-ıyor	1
kapat	kapat	3
kapatabilirim	kapat-abil-ir-im	1
kapatalım	kapa-t-a-lı-m	2
kapatamazsın	kapa-t-a-ma-z-sın	1
kapatayım	kapat-a-yım	2
kapattı	kapa-t-tı	1
kapattık	kapa-t-tı-k	1
kapattın	kapat-tı-n	2
kapatıyorsun	kapat-ıyor-sun	2
kapatıyorum	kapa-t-ıyor-um	1
kapağı	kapağ-ı	1
kapağın	kapağ-ın	1
kapağını	kapağ-ı-nı	2
kaptan	kaptan	3
kaptanı	kaptan-ı	3
kapı	kapı	6
kapıcı	kapı-cı	1
kapıları	kapı-lar-ı	3
kapının	kapı-nın	4
kapısı	kapı-sı	11
kapısından	kapı-sı-ndan	1
kapıyayım	kapı-ya-yım	1
kapıyorsun	kap-ıyor-sun	2
kapıyı	kapı-yı	4
kar	kar	2
kara	kara	4
karanlık	karanlık	2
karanlıkta	karanlık-ta	2
kardan	kar-dan	1
kardeş	kardeş	2
kardeşi	kardeş-i	1
kardeşim	kardeş-im	2
kardeşin	kardeş-in	13
kardeşine	kardeş-i-ne	1
kardeşini	kardeş-i-ni	4
kardeşlere	kardeş-ler-e	1
kardeşlerin	kardeş-ler-in	1
karga	karga	4
karganı	karga-n-ı	1
karganın	karga-nın	3
kargayla	karga-yla	6
kargayı	karga-yı	4
karmakarışık	karma+karışık	3
karnım	karn-ım	1
karnın	karn-ın	6
karnından	karn-ı-ndan	1
karpuz	karpuz	1
kartal	kartal	1
karı	karı	1
karın	kar-ın	1
karınları	karın-lar-ı	2
karıyı	karı-yı	1
karıştırdık	karış-tır-dı-k	1
karıştırma	karış-tır-ma	1
karıştırıyor	karış-tır-ıyor	1
karşıda	karşı-da	3
karşıki	karşı-ki	1
karşında	karşı-n-da	1
karşısına	karşı-sı-na	1
karşıya	karşı-ya	1
katta	kat-ta	1
kavga	kavga	2
kayabiliyor	kay-abil-iyor	1
kayacak	kay-acak	2
kayak	kayak	4
kayakla	kayak-la	1
kayaklar	kayak-lar	1
kayakların	kayak-lar-ın	1
kayarken	kayar-ken	1
kaybettim	kaybet-ti-m	1
kaydı	kayd-ı	1
kaydın	kayd-ın	1
kaysın	kay-sın	1
kayık	kayık	1
kayılır	kay-ıl-ır	1
kayıp	kayıp	1
kayıyor	kay-ıyor	4
kayığı	kayığ-ı	1
kaz	kaz	3
kaza	kaza	3
kazakçı	kazak-çı	1
kazandığın	kazan-dığ-ın	1
kazanmaya	kazan-ma-ya	3
kazanıyor	kazan-ıyor	3
kazarlar	kaz-ar-lar	1
kazağa	kazağ-a	1
kazağı	kazağ-ı	3
kazağımdaki	kazağı-m-da-ki	2
kazağın	kazağ-ın	3
kazağında	kazağ-ı-nda	2
kazmak	kaz-mak	2
kazı	kazı	1
kazın	kaz-ın	2
kazıyor	kazı-yor	1
kazıyorlar	kaz-ıyor-lar	1
kazıyorsun	kaz-ıyor-sun	1
kazıyorsunuz	kaz-ıyor-sunuz	1
kaç	kaç	43
kaçacak	kaç-acak	1
kaçamazsınız	kaç-a-ma-z-sınız	1
kaçmış	kaç-mış	1
kaçta	kaç-ta	6
kaçı	kaç-ı	1
kaçıncı	kaç-ıncı	2
kaçıyor	kaç-ıyor	4
kaçıyordu	kaç-ıyor-du	1
kaçıyorlar	kaç-ıyor-lar	1
kağıdı	kağıd-ı	1
kağıdın	kağıd-ın	3
kağıt	kağıt	10
kağıtlar	kağıt-lar	1
kaşlarını	kaş-ları-nı	1
kaşı	kaş-ı	2
kaşık	kaşık	3
kaşıkla	kaşıkla	1
kebapçıya	kebap-çı-ya	1
kedi	kedi	63
kediden	kedi-den	1
kediler	kedi-ler	94
kedilerden	kedi-ler-den	3
kedilere	kedi-ler-e	3
kedileri	kedi-ler-i	10
kedilerin	kedi-ler-in	2
kedilerini	kedi-ler-i-ni	1
kedilerle	kedi-ler-le	1
kedim	kedi-m	1
kedimi	kedi-m-i	2
kedin	kedi-n	10
kedinin	kedi-nin	13
kediniz	kedi-niz	8
kedisi	kedi-si	2
kedisiymiş	kedi-si-ymiş	1
kedisiz	kedi-siz	1
kediye	kedi-ye	3
kediyi	kedi-yi	4
kediyle	kedi-yle	1
kediymiş	kedi-ymiş	2
kelemle	kelem-le	3
kelimeler	kelime-ler	1
kemer	kemer	1
kemeri	kemer-i	1
kemiği	kemiğ-i	1
kenar	kenar	1
kenara	kenar-a	1
kenarına	kenar-ı-na	4
kenarında	kenar-ı-nda	3
kendi	kendi	11
kendim	kendi-m	4
kendime	kendi-m-e	1
kendin	kendi-n	2
kendinden	kendi-nden	1
kendine	kendi-ne	2
kendini	kendi-ni	1
kendinin	kendi-nin	1
kendininkileri	kendi-nin-ki-leri	1
kendisi	kendisi	2
kepçeyle	kepçe-yle	1
kere	kere	10
kerem	kerem	1
kerim	kerim	6
kerimden	kerim-den	1
kerime	kerime	3
kerimi	kerim-i	1
keriminki	kerim-in-ki	1
keser	keser	2
kesilince	kes-il-ince	1
kesiyor	kes-iyor	3
kesmiyorlar	kes-mi-yor-lar	1
kestim	kes-ti-m	5
kestin	kes-ti-n	3
kestireceksin	kes-tir-ecek-sin	3
kezban	kezban	6
keçi	keçi	9
keçiciği	keçi-ciğ-i	1
keçiler	keçi-ler	3
keçiyi	keçi-yi	1
ki	ki	58
kibritin	kibrit-in	1
kilyosta	kilyos-ta	1
kim	kim	453
kimde	kim-de	2
kimdi	kim-di	3
kimdir	kim-dir	1
kime	kim-e	43
kimi	kimi	25
kimin	kim-in	29
kimindi	kim-in-di	1
kiminle	kim-in-le	47
kimle	kim-le	61
kimler	kim-ler	46
kimlerdi	kim-ler-di	1
kimlere	kim-ler-e	2
kimleri	kim-ler-i	1
kimlerin	kim-ler-in	1
kimlerle	kim-ler-le	7
kimmiş	kim-miş	3
kimse	kimse	4
kimseden	kimse-den	1
kimseye	kimse-ye	1
kimseyle	kimse-yle	1
kimsiniz	kim-siniz	2
kirazın	kiraz-ın	1
kirlendiği	kir-len-diğ-i	1
kirleniyor	kir-len-iyor	3
kirletiyor	kirlet-iyor	2
kirletiyorsun	kirlet-iyor-sun	1
kirletiyorsunuz	kirlet-iyor-sunuz	1
kirletmiş	kirlet-miş	2
kirli	kir-li	1
kirpiklerini	kirpik-ler-i-ni	1
kitabı	kitab-ı	5
kitabın	kitab-ın	1
kitabında	kitab-ı-nda	1
kitap	kitap	18
kitaplar	kitap-lar	2
kitapları	kitap-lar-ı	7
kitapların	kitap-lar-ın	3
kitaplarını	kitap-lar-ı-nı	1
kitaptan	kitap-tan	1
kişi	kişi	2
kocaman	kocaman	12
kokladı	kokla-dı	1
kokmadı	kok-ma-dı	2
koku	koku	1
kokusu	koku-su	1
kokuyor	kok-uyor	2
kolay	kolay	3
kolejde	kolej-de	4
koleje	kolej-e	2
kolejin	kolej-in	1
kolları	kol-lar-ı	1
kollarına	kol-lar-ı-na	1
kolonyası	kolonya-sı	1
koltuktan	koltuk-tan	1
kolu	kol-u	1
koluna	kol-u-na	1
kolunu	kol-u-nu	2
komik	komik	1
komşu	komşu	1
komşular	komşu-lar	1
komşunun	komşu-nun	1
konabilir	kon-abil-ir	1
konarlar	kon-ar-lar	1
kondu	kon-du	1
konsun	kon-sun	2
kont	kont	1
konuyor	kon-uyor	2
konuş	kon-uş	6
konuşabilir	konuş-abil-ir	2
konuşabiliyor	konuş-abil-iyor	1
konuşacak	konuş-acak	2
konuşacaksın	konuş-acak-sın	2
konuşacağız	konuş-acağ-ız	2
konuşalım	konuş-a-lı-m	5
konuşamaz	konuş-a-ma-z	1
konuşmadan	konuşma-dan	1
konuşmadık	konuş-ma-dı-k	1
konuşmak	konuş-mak	2
konuşmanı	konuşma-n-ı	2
konuşmasını	konuşma-sı-nı	1
konuşmayacaksan	konuş-ma-yacak-sa-n	1
konuşmuyor	konuş-mu-yor	1
konuşmuyorsun	konuş-mu-yor-sun	2
konuşsan	konuş-sa-n	1
konuşsana	konuş-sana	1
konuşsunlar	konuş-sunlar	4
konuşta	kon-uş-ta	1
konuştu	konuş-tu	1
konuştum	konuş-tu-m	1
konuştur	kon-uş-tur	4
konuşturayım	konuş-tur-a-yım	1
konuşurlar	konuş-ur-lar	4
konuşursan	konuş-ur-sa-n	1
konuşurum	konuş-ur-um	2
konuşuyor	konuş-uyor	4
konuşuyordun	konuş-uyor-du-n	1
konuşuyorlar	konuş-uyor-lar	1
konuşuyorlarmış	konuş-uyor-lar-mış	1
konuşuyorsun	konuş-uyor-sun	3
konuşuyoruz	konuş-uyor-uz	1
koparayım	kopar-a-yım	1
koparma	kopar-ma	1
kopartmak	kopar-t-mak	1
koparttı	kopar-t-tı	1
kopartınca	kopar-t-ınca	1
koparırsan	kopar-ır-sa-n	1
koparıyorlar	kopar-ıyor-lar	1
kopmuş	kop-muş	3
koptu	kop-tu	1
kordon	kordon	2
kordonun	kordon-un	1
korkacak	kork-acak	1
korkacağız	kork-acağ-ız	1
korkarsa	kork-ar-sa	1
korkarsın	kork-ar-sın	2
korkarım	kork-ar-ım	2
korkmadı	kork-ma-dı	2
korkmaz	kork-ma-z	2
korkmuyor	kork-mu-yor	1
korkmuyorsun	kork-mu-yor-sun	1
korktum	kork-tu-m	2
korktun	kork-tu-n	1
korkup	kork-up	1
korkutma	kork-ut-ma	1
korkuttun	kork-ut-tu-n	1
korkuyor	kork-uyor	1
korkuyorsun	kork-uyor-sun	3
korkuyorum	kork-uyor-um	2
kornayı	korna-yı	1
korunun	koru-nun	1
koskocaman	koskocaman	1
kovaladı	kovala-dı	1
kovaları	kova-lar-ı	1
kovaların	kova-lar-ın	1
kovan	kov-an	3
kovboy	kovboy	3
kovboya	kovboy-a	2
kovboyculuk	kovboy-cu-luk	2
kovboyun	kovboy-un	1
koy	koy	13
koyabiliriz	koy-abil-ir-iz	1
koyabilirsin	koy-abil-ir-sin	1
koyacak	koy-acak	2
koyacaksın	koy-acak-sın	5
koyacağım	koy-acağ-ım	1
koyacağız	koy-acağ-ız	2
koyalım	koy-a-lı-m	14
koyar	koy-ar	1
koyarsın	koyar-sın	1
koyarım	koy-ar-ım	1
koyayım	koy-a-yım	11
koydu	koy-du	2
koyduk	koy-du-k	2
koydular	koy-du-lar	3
koydum	koy-du-m	2
koydun	koy-du-n	13
koyma	koy-ma	3
koymak	koy-mak	1
koymamı	koy-ma-mı	1
koymasın	koy-ma-sın	1
koymuş	koy-muş	1
koymuşlar	koy-muş-lar	1
koymuşsun	koy-muş-sun	1
koymuştun	koy-muş-tu-n	1
koysam	koy-sa-m	1
koysan	koy-sa-n	1
koyuna	koy-u-na	1
koyunca	koy-unca	2
koyup	koy-up	2
koyuyor	koy-uyor	9
koyuyorsun	koy-uyor-sun	7
koyuyorum	koy-uyor-um	1
koyuyoruz	koy-uyor-uz	1
koş	koş	5
koşa	koş-a	4
koşabilir	koş-abil-ir	5
koşabilirler	koş-abil-ir-ler	3
koşabiliyor	koş-abil-iyor	1
koşamazlar	koş-a-ma-z-lar	1
koşar	koş-ar	45
koşarlar	koş-ar-lar	16
koşarsın	koş-ar-sın	13
koşmaca	koşmaca	1
koşmak	koş-mak	2
koşmayalım	koş-ma-ya-lı-m	1
koşmazlar	koş-ma-z-lar	3
koşmuyor	koş-mu-yor	2
koşsun	koş-sun	4
koşsunlar	koş-sunlar	2
koştu	koş-tu	1
koştular	koş-tu-lar	1
koştun	koş-tu-n	7
koştunuz	koş-tu-nuz	3
koşturabilir	koş-tur-abil-ir	1
koştursana	koş-tur-sana	1
koştursun	koştur-sun	1
koşup	koş-up	1
koşuyor	koş-uyor	19
koşuyorlar	koş-uyor-lar	11
koşuyorlardı	koş-uyor-lar-dı	1
koşuyorsun	koş-uyor-sun	5
kreminin	krem-i-nin	1
kubilay	kubilay	2
kubilaya	kubilay-a	1
kucak	kucak	1
kucağı	kucağ-ı	1
kucağımda	kucağ-ım-da	1
kucağımdan	kucağ-ım-dan	2
kucağına	kucağ-ı-na	1
kucağında	kucağ-ı-nda	1
kulakları	kulak-lar-ı	1
kulaklarımı	kulak-lar-ım-ı	1
kulağı	kulağ-ı	1
kulağıma	kulağ-ım-a	1
kulağında	kulağ-ı-nda	1
kule	kule	2
kulelerle	kule-ler-le	1
kuleni	kule-n-i	1
kuleyle	kule-yle	1
kullanmıyor	kullan-mı-yor	2
kullansın	kullan-sın	1
kullanılıyor	kullan-ıl-ıyor	2
kullanın	kullan-ın	1
kullanırlar	kullan-ır-lar	1
kullanıyor	kullan-ıyor	18
kullanıyorsun	kullan-ıyor-sun	2
kulübe	kulüb-e	2
kulübü	kulüb-ü	3
kulüp	kulüp	2
kulüpte	kulüp-te	1
kum	kum	4
kumburgaz	kumburgaz	3
kumburgaza	kumburgaz-a	1
kumburgazda	kumburgaz-da	2
kumburgazdaki	kumburgaz-da-ki	1
kumda	kum-da	1
kumu	kum-u	1
kundakta	kundak-ta	2
kurabiye	kurabiye	2
kuran	kur-an	1
kurda	kurd-a	2
kurdu	kur-du	2
kurdun	kurd-un	3
kurnaz	kurnaz	1
kurt	kurt	41
kurtlar	kurt-lar	33
kurtlardan	kurt-lar-dan	1
kurtları	kurt-lar-ı	9
kurttan	kurt-tan	1
kurusunlar	kuru-sunlar	1
kusuyor	kus-uyor	1
kusuyorsun	kus-uyor-sun	1
kutu	kutu	5
kutuna	kut-u-na	1
kutunun	kutu-nun	7
kutusu	kutu-su	3
kutuyu	kutu-yu	1
kuvvetin	kuvvet-in	2
kuvvetli	kuvvet-li	5
kuvvetlisin	kuvvet-li-sin	3
kuyruk	kuyruk	1
kuyruklarıyla	kuyruk-lar-ı-yla	1
kuyruğu	kuyruğ-u	11
kuyruğun	kuyruğ-un	1
kuyruğunu	kuyruğ-u-nu	1
kuyu	kuyu	2
kuyuda	kuyu-da	2
kuyun	kuyu-n	1
kuyuyu	kuyu-yu	2
kuzu	kuzu	11
kuzular	kuzu-lar	1
kuş	kuş	32
kuşa	kuş-a	1
kuşağı	kuşağ-ı	1
kuşlar	kuş-lar	68
kuşlara	kuş-lar-a	6
kuşları	kuş-lar-ı	9
kuşların	kuş-lar-ın	6
kuşoğlu	kuşoğlu	3
kuşu	kuş-u	3
kuşum	kuş-um	1
kuşun	kuş-un	18
kuşunu	kuş-u-nu	1
kömür	kömür	2
köpek	köpek	68
köpekle	köpekle	1
köpekler	köpek-ler	83
köpeklerden	köpek-ler-den	3
köpeklere	köpek-ler-e	2
köpekleri	köpek-leri	11
köpeklerin	köpek-ler-in	1
köpekleriniz	köpek-ler-in-iz	1
köpeklerle	köpek-ler-le	2
köpekten	köpek-ten	1
köpeğe	köpeğ-e	1
köpeği	köpeğ-i	6
köpeğin	köpeğ-in	2
köpeğiniz	köpeğ-iniz	1
köprü	köprü	8
köprünün	köprü-nün	13
köprüsü	köprü-sü	1
köprüyü	köprü-yü	2
köpük	köpük	1
kötü	kötü	8
kötüydü	kötü-ydü	1
köyde	köy-de	2
köye	köy-e	1
köyü	köy-ü	1
köşede	köşe-de	1
kül	kül	1
küpe	küpe	2
küpeleri	küpe-ler-i	1
küpem	küpe-m	1
kürek	kürek	1
küreğin	küreğ-in	1
kürkü	kürk-ü	1
küstüm	küs-tü-m	1
küvetin	küvet-in	1
küçücük	küçücük	3
küçük	küçük	35
küçükleri	küçük-leri	1
küçüksuya	küçüksu-ya	1
küçült	küçül-t	1
kılçıkları	kılçık-lar-ı	1
kılıcın	kılıc-ın	1
kılıç	kılıç	3
kıracaksın	kır-acak-sın	1
kırarsın	kır-ar-sın	1
kırdı	kır-dı	1
kırdılar	kır-dı-lar	1
kırdın	kır-dı-n	1
kırmak	kır-mak	1
kırmıyorum	kır-mı-yor-um	2
kırmızı	kırmızı	10
kırmızıyı	kırmızı-yı	1
kırılacağa	kır-ıl-acağ-a	1
kırıldı	kır-ıl-dı	7
kırılmadı	kır-ıl-ma-dı	1
kırılmıyor	kır-ıl-mı-yor	1
kırılmış	kır-ıl-mış	2
kırılınca	kır-ıl-ınca	2
kırılır	kır-ıl-ır	1
kısa	kısa	6
kısmı	kısm-ı	2
kıvır	kıvır	1
kıvırabilir	kıvır-abil-ir	1
kıvırcık	kıvırcık	2
kıvırmıyor	kıvır-mı-yor	1
kıyameti	kıyamet-i	1
kıyma	kıyma	1
kıymetli	kıymet-li	1
kız	kız	61
kıza	kız-a	3
kızacak	kız-acak	1
kızar	kız-ar	3
kızarttım	kızart-tı-m	1
kızartıyor	kızart-ıyor	1
kızdı	kız-dı	4
kızdırdı	kız-dır-dı	1
kızdırıyor	kız-dır-ıyor	1
kızkardeşini	kız+kardeş-i-ni	1
kızla	kız-la	5
kızlar	kız-lar	1
kızlarla	kız-lar-la	1
kızmıyor	kız-mı-yor	2
kızmış	kız-mış	2
kızsaydın	kız-sa-ydı-n	1
kızsın	kız-sın	1
kızı	kız-ı	2
kızılaya	kızılay-a	1
kızılderili	kızıl+derili	2
kızım	kız-ım	34
kızıma	kız-ım-a	1
kızımın	kız-ım-ın	1
kızın	kız-ın	1
kızınca	kız-ınca	1
kızıyor	kız-ıyor	2
kızıyorum	kız-ıyor-um	2
kışlıkları	kış-lık-ları	1
laf	laf	1
lahanayı	lahana-yı	1
lama	lama	4
lamba	lamba	3
lambası	lamba-sı	2
lazım	lazım	21
lego	lego	1
levent	levent	13
leventçiğim	levent-çiğim	1
limon	limon	1
limonata	limonata	2
lunapark	lunapark	1
lunaparka	lunapark-a	2
lunaparkta	lunapark-ta	2
lütfen	lütfen	5
lüzum	lüzum	2
lüzumu	lüzum-u	1
madamın	madam-ın	4
madem	madem	1
mahmut	mahmut	1
mahsusçuktan	mahsusçuktan	6
makara	makara	2
makaraları	makara-lar-ı	1
makarana	makara-n-a	1
makarayı	makara-yı	1
makarna	makarna	3
makarnası	makarna-sı	1
makarnasın	makarna-sın	1
makarnaysan	makarna-ysa-n	1
makina	makina	1
makinası	makina-sı	1
mama	mama	5
mamaları	mama-lar-ı	1
maması	mama-sı	1
mamasını	mama-sı-nı	2
mamayı	mama-yı	1
mandalinaları	mandalina-lar-ı	1
mandolin	mandolin	2
markası	marka-sı	2
markaydı	marka-ydı	1
marmaris	marmaris	1
marmariste	marmaris-te	2
martı	martı	3
masa	masa	3
masada	masa-da	2
masal	masal	22
masalcı	masal-cı	1
masalları	masal-lar-ı	1
masalı	masal-ı	2
masalını	masal-ın-ı	3
masanın	masa-nın	6
masası	masa-sı	1
masaya	masa-ya	1
masaymış	masa-ymış	1
mavi	mavi	4
maymun	maymun	8
maymuna	maymun-a	1
maymunlar	maymun-lar	1
maymunu	maymun-u	2
maymunum	maymun-um	1
mayo	mayo	1
mayon	mayo-n	2
mayonla	mayo-n-la	2
maçlarını	maç-lar-ı-nı	1
maçı	maç-ı	1
maçını	maç-ı-nı	1
mecburen	mecburen	1
mehmet	mehmet	1
mehmetçiki	mehmet-çik-i	1
mehmetçiği	mehmet-çiğ-i	1
mekik	mekik	2
mektebe	mekteb-e	4
mektep	mektep	1
mektepten	mektep-ten	2
mektubu	mektub-u	1
mektup	mektup	3
mektupta	mektup-ta	1
melahata	melahat-a	1
meme	meme	1
memeleri	meme-ler-i	1
memesi	meme-si	1
memnun	memnun	1
memoya	memo-ya	1
merak	merak	1
mercedes	mercedes	2
mercedesi	mercedes-i	1
merdiven	merdiven	3
merdivenin	merdiven-in	1
mersi	mersi	6
mesela	mesela	7
metinin	metin-in	1
meyva	meyva	4
meyvası	meyva-sı	1
mi	mi	819
midir	mi-dir	1
migros	migros	1
mikrofon	mikrofon	5
mikrofona	mikrofon-a	1
mikrofonla	mikrofon-la	2
mikrofonu	mikrofon-u	2
mikrofonun	mikrofon-un	1
minik	minik	1
mis	mis	2
misafir	misafir	5
misafirler	misafir-ler	1
misafirleri	misafir-ler-i	2
misafirliğe	misafir-liğ-e	3
misin	mi-sin	101
misiniz	mi-siniz	2
misketleri	misket-ler-i	3
miyav	miyav	8
miydi	mi-ydi	9
miydin	mi-ydi-n	1
miyim	mi-yim	8
miyiz	mi-yiz	3
mm	mm	2
montaj	montaj	1
motor	motor	1
motoru	motor-u	5
mu	mu	395
mum	mum	1
mumlar	mumla-r	1
murat	murat	11
muratla	murat-la	3
muratçığım	murat-çığ-ım	4
musa	musa	2
musanın	musa-nın	1
mustafa	mustafa	10
mustafacım	mustafa-cı-m	1
mustafayla	mustafa-yla	1
musun	mu-sun	438
musunuz	mu-sunuz	36
mutfak	mutfak	1
mutfakta	mutfak-ta	1
mutfağı	mutfağ-ı	1
muydu	mu-ydu	4
muydun	mu-ydu-n	3
muymuş	mu-ymuş	3
muyum	mu-yum	1
muyuz	mu-yuz	9
muzaffer	muzaffer	1
muş	muş	3
muşsun	muş-sun	1
mü	mü	108
müge	müge	2
mügeyle	müge-yle	3
mühim	mühim	1
müsaade	müsaade	1
müsün	mü-sün	1
müydü	mü-ydü	3
müzik	müzik	1
müziği	müziğ-i	1
mı	mı	712
mıstık	mıstık	3
mısın	mı-sın	93
mısınız	mı-sınız	1
mısır	mısır	2
mıydı	mı-ydı	16
mıymış	mı-ymış	5
mıyız	mı-yız	2
mızıkacılarını	mızıka-cı-ları-nı	1
nafiye	nafiye	2
namlusu	namlu-su	1
nane	nane	1
nasıl	nasıl	468
nasıldı	nasıl-dı	3
nasıldır	nasıl-dır	1
nasılsın	nasıl-sın	3
nasılsınız	nasıl-sınız	3
nazanların	nazan-lar-ın	1
nazanın	nazan-ın	1
ne	ne	2244
neden	neden	37
nedime	nedime	1
nedimeyle	nedime-yle	1
nedir	ne-dir	24
nefesine	nefes-i-ne	4
nefis	nefis	2
nehirlerde	nehir-ler-de	1
neler	ne-ler	106
nelerden	ne-ler-den	1
neleri	ne-ler-i	6
neleriyle	ne-leri-yle	3
nelerle	ne-ler-le	2
nene	nene	3
nenen	nene-n	1
nerde	ner-de	224
nerdeler	ner-de-ler	1
nerden	ner-den	53
nerdesin	ner-de-sin	1
nerdeydi	ner-de-ydi	1
nerdeydiniz	ner-de-ydi-niz	1
nerede	nere-de	84
neredeler	nere-de-ler	1
nereden	nere-den	15
neredeydi	nere-de-ydi	1
neredeydin	nere-de-ydi-n	2
neredeymiş	nere-de-ymiş	3
nerelerdeydin	nere-ler-de-ydi-n	1
nerelere	nere-ler-e	1
nereleri	nere-leri	1
nerende	nere-n-de	1
nereni	nere-n-i	1
neresi	nere-si	38
neresinde	nere-si-nde	17
neresinden	nere-si-nden	5
neresine	nere-si-ne	6
neresini	nere-si-n-i	3
nereye	nere-ye	193
nesi	ne-si	69
nesin	ne-sin	2
nesini	ne-si-ni	5
nevcihan	nevcihan	1
neydi	ne-ydi	6
neye	ne-ye	22
neyi	ne-yi	41
neyim	ne-yim	2
neyin	ne-yin	44
neyini	ne-yi-ni	2
neyiniz	ne-yiniz	1
neyle	ne-yle	180
neymiş	ne-ymiş	6
nezih	nezih	7
nezihin	nezih-in	2
nihali	nihal-i	1
nihan	nihan	1
nihandan	nihan-dan	1
nihanla	nihan-la	1
nihanın	nihan-ın	1
nine	nine	4
ninenin	nine-nin	1
ninni	ninni	1
nisan	nisan	2
niye	niye	330
niyetin	niyet-in	1
niçin	niçin	187
nişantaşında	nişantaşı-n-da	1
nokta	nokta	3
not	not	1
numarası	numara-sı	1
nuran	nuran	1
o	o	362
ocağın	ocağ-ın	1
odada	oda-da	12
odaları	oda-lar-ı	1
odamdan	oda-m-dan	1
odan	oda-n	2
odana	oda-n-a	1
odası	oda-sı	1
ofisi	ofis-i	1
oje	oje	1
ojeleri	oje-ler-i	1
ojeyle	oje-yle	2
okadar	okadar	1
okuduğunu	oku-duğ-u-nu	1
okula	okul-a	25
okulda	okul-da	14
okuldaki	okul-da-ki	1
okuldan	okul-dan	1
okulu	okul-u	3
okuluna	okul-u-na	1
okulunu	okul-u-nu	1
okumak	oku-mak	2
okumuyor	oku-mu-yor	3
okunuyor	oku-n-uyor	1
okur	okur	32
okuyabilir	oku-yabil-ir	2
okuyacak	oku-yacak	2
okuyacağız	oku-yacağ-ız	1
okuyalım	oku-ya-lı-m	2
okuyayım	oku-ya-yım	1
okuyor	oku-yor	49
okuyum	ok-u-yum	3
okşadı	okşa-dı	1
ol	ol	2
olabilir	ol-abil-ir	1
olacak	ol-acak	27
olacaksın	ol-acak-sın	5
olan	ol-an	1
olarak	ol-arak	2
olayım	ol-a-yım	2
oldu	ol-du	106
oldum	ol-du-m	1
oldun	ol-du-n	4
olduğu	ol-duğ-u	5
olduğun	ol-duğ-un	5
olduğunu	ol-duğ-u-nu	4
olguna	olgun-a	1
olmadı	ol-ma-dı	5
olmadın	ol-ma-dı-n	2
olmamış	ol-ma-mış	2
olmasa	ol-ma-sa	4
olmasaydı	ol-ma-sa-ydı	5
olması	ol-ma-sı	2
olmasın	ol-ma-sın	1
olmayınca	ol-ma-yınca	3
olmaz	ol-ma-z	14
olmazsa	ol-ma-z-sa	1
olmuyor	ol-mu-yor	1
olmuş	ol-muş	31
olmuştu	ol-muş-tu	3
olsa	ol-sa	1
olsaydı	ol-sa-ydı	1
olsun	ol-sun	34
olsunlar	ol-sunlar	2
oltalar	olta-lar	1
olunca	ol-unca	9
olur	ol-ur	75
olurdu	ol-ur-du	4
olurken	ol-ur-ken	1
olursa	ol-ur-sa	1
olursan	olur-sa-n	1
olursun	ol-ur-sun	1
olurum	ol-ur-um	2
oluyor	ol-uyor	40
oluyorlar	ol-uyor-lar	1
oluyorsun	ol-uyor-sun	2
omo	omo	1
ona	o-na	33
onbeş	onbeş	1
ondan	o-ndan	27
oniki	oniki	1
onla	o-nla	5
onlar	o-nlar	71
onlara	o-nlar-a	5
onlarda	o-nlar-da	2
onlardan	o-nlar-dan	2
onlarla	o-nlar-la	14
onları	o-nlar-ı	38
onların	o-nlar-ın	5
onu	o-nu	149
onun	o-nun	56
onunla	o-nunla	3
orada	ora-da	32
oradaki	ora-da-ki	1
oradan	ora-dan	6
oralara	ora-lar-a	1
oralarda	ora-lar-da	1
oralarını	ora-ları-nı	1
orası	ora-sı	24
orasını	ora-sı-nı	3
oraya	ora-ya	16
orayı	ora-yı	1
orda	or-da	58
ordaki	or-da-ki	1
ordan	or-dan	16
ormana	orman-a	2
ormanda	orman-da	3
ortadan	orta-dan	1
ortalarda	orta-lar-da	1
ortaokulun	ortaokul-un	2
ortasına	orta-sı-na	2
ortasında	orta-sı-nda	2
ortaya	orta-ya	1
osmanla	osman-la	1
otobüs	otobüs	12
otobüse	otobüs-e	4
otobüsle	otobüs-le	1
otobüsler	otobüs-ler	2
otobüsten	otobüs-ten	1
otobüsü	otobüs-ü	2
otobüsün	otobüs-ün	3
otobüsüymüş	otobüs-ü-ymüş	1
otomobil	otomobil	2
otomobiller	otomobil-ler	1
otur	otur	30
oturabilir	otur-abil-ir	2
oturacağı	otur-acağ-ı	1
oturalım	otur-a-lı-m	1
oturayım	otur-a-yım	1
oturdu	otur-du	1
oturdun	otur-du-n	1
oturduğu	otur-duğ-u	1
oturduğun	otur-duğ-un	2
oturmuyor	otur-mu-yor	1
oturmuyorum	otur-mu-yor-um	1
otursun	otur-sun	8
otursunlar	otur-sunlar	3
oturtuyorsun	otur-t-uyor-sun	2
oturur	otur-ur	3
oturuyor	otur-uyor	38
oturuyorlar	otur-uyor-lar	5
oturuyormuş	otur-uyor-muş	3
oturuyorsun	otur-uyor-sun	3
oturuyorsunuz	otur-uyor-sunuz	4
oturuyoruz	otur-uyor-uz	4
oy	oy	1
oyna	oyna	6
oynadı	oyna-dı	1
oynadın	oyna-dı-n	22
oynadınız	oyna-dı-nız	9
oynadığını	oyna-dığ-ı-nı	2
oynama	oyna-ma	2
oynamak	oyna-mak	10
oynamam	oyna-ma-m	3
oynamanı	oyna-ma-nı	1
oynamasını	oyna-ma-sı-nı	1
oynamaya	oyna-ma-ya	1
oynamayayım	oyna-ma-ya-yım	1
oynamayı	oyna-ma-yı	2
oynamaz	oyna-ma-z	2
oynamıyor	oyna-mı-yor	10
oynamıyorlar	oyna-mı-yor-lar	1
oynamıyorsun	oyna-mı-yor-sun	6
oynamıştık	oyna-mış-tı-k	1
oynanır	oyna-n-ır	2
oynanırken	oyna-n-ır-ken	1
oynanıyor	oyna-n-ıyor	6
oynar	oyna-r	26
oynarken	oyna-r-ken	1
oynarlar	oyna-r-lar	35
oynarmış	oyna-r-mış	1
oynarsın	oyna-r-sın	67
oynarsınız	oyna-r-sınız	7
oynarız	oyna-r-ız	4
oynasa	oyna-sa	1
oynasın	oyna-sın	2
oynasınlar	oyna-sınlar	5
oynat	oyna-t	1
oynatacam	oyna-t-a-ca-m	1
oynatırım	oyna-t-ır-ım	1
oynatıyorum	oyna-t-ıyor-um	1
oynayabilecek	oyna-yabil-ecek	1
oynayabilirler	oyna-yabil-ir-ler	3
oynayabilirsin	oyna-yabil-ir-sin	3
oynayabiliyor	oyna-yabil-iyor	1
oynayacak	oyna-yacak	2
oynayacaklar	oyna-yacak-lar	3
oynayacaksın	oyna-yacak-sın	4
oynayacaksınız	oyna-yacak-sınız	2
oynayacaktı	oyna-yacak-tı	1
oynayacağım	oyna-yacağ-ım	2
oynayacağız	oyna-yacağ-ız	18
oynayalım	oyna-ya-lı-m	21
oynayamaz	oyna-ya-ma-z	1
oynayamıyor	oyna-ya-mı-yor	1
oynuyor	oynu-yor	64
oynuyordu	oynu-yor-du	2
oynuyordun	oynu-yor-du-n	2
oynuyordur	oynu-yor-dur	2
oynuyorlar	oynu-yor-lar	15
oynuyorlardı	oynu-yor-lar-dı	1
oynuyorsun	oynu-yor-sun	53
oynuyorsunuz	oynu-yor-sunuz	37
oynuyoruz	oynu-yor-uz	8
oyun	oyun	25
oyuncak	oyuncak	15
oyuncaklar	oyuncak-lar	6
oyuncaklardan	oyuncak-lar-dan	1
oyuncakları	oyuncak-lar-ı	7
oyuncaklarım	oyuncak-lar-ım	1
oyuncaklarımla	oyuncak-lar-ım-la	2
oyuncaklarımı	oyuncak-lar-ım-ı	4
oyuncakların	oyuncak-lar-ın	8
oyuncaklarınla	oyuncak-lar-ın-la	1
oyuncaklarını	oyuncak-lar-ı-nı	3
oyuncaklarının	oyuncak-lar-ı-nın	1
oyuncaklarınız	oyuncak-lar-ın-ız	1
oyuncakçı	oyuncak-çı	1
oyuncakçıdan	oyuncak-çı-dan	1
oyuncağı	oyuncağ-ı	4
oyuncağım	oyuncağ-ım	1
oyuncağın	oyuncağ-ın	1
oyuncağından	oyuncağ-ı-ndan	1
oyundan	oyun-dan	1
oyunlar	oyun-lar	29
oyunları	oyun-lar-ı	17
oyunu	oyun-u	19
oyununu	oyun-u-nu	1
oğlan	oğlan	34
oğlana	oğlan-a	9
oğlanla	oğlan-la	2
oğlanlara	oğlan-lar-a	1
oğlansın	oğlan-sın	1
oğlanı	oğlan-ı	1
oğlu	oğl-u	1
oğlum	oğl-um	18
oğlusun	oğl-u-sun	2
pabuç	pabuç	1
pabuçlar	pabuç-lar	1
pabuçlarını	pabuç-lar-ı-nı	2
pahalı	paha-lı	4
pahalıymış	pahalı-ymış	1
paketin	paket-in	1
pakette	paket-te	1
pamuk	pamuk	1
pamuklar	pamuk-lar	1
pantalon	pantalon	1
pantalonun	pantalon-un	1
pantalonunu	pantalon-u-nu	1
pantolon	pantolon	3
pantolonlarını	pantolon-lar-ı-nı	2
pantolonu	pantolon-u	3
pantolonun	pantolon-un	3
pantolonunu	pantolon-u-nu	2
para	para	9
paran	para-n	3
parayla	para-yla	2
pardon	pardon	1
paris	paris	1
park	park	9
parka	parka	2
parkta	park-ta	9
parkın	park-ın	1
parkında	park-ı-nda	1
parmağın	parmağ-ın	1
parmağına	parmağ-ı-na	1
parça	parça	5
paspası	paspas-ı	1
pasta	pasta	6
pastahanede	pastahane-de	1
pastahanesinde	pasta+hane-si-nde	1
pastahanesine	pasta+hane-si-ne	1
pastamı	pasta-m-ı	1
pastası	pasta-sı	1
pastayı	pasta-yı	2
patates	patates	2
patik	patik	1
patikler	patik-ler	1
patiklerine	patik-ler-i-ne	1
patlar	patla-r	1
patlatıyorsun	patla-t-ıyor-sun	1
patlıyor	patlı-yor	1
pazar	pazar	2
pazuların	pazu-lar-ın	6
pek	pek	26
pekala	pekala	4
peki	peki	437
pekiyi	pekiyi	7
pelinciğim	pelin-ciğ-im	3
pelini	pelin-i	1
pelinin	pelin-in	1
pelinle	pelin-le	1
pencere	pencere	1
pencereden	pencere-den	4
pencerelerini	pencere-leri-ni	1
penceresi	pencere-si	2
penceresinden	pencere-si-nden	1
pencereye	pencere-ye	1
perde	perde	4
perdesi	perde-si	1
peruda	peru-da	1
pervanesi	pervane-si	1
pervaneyi	pervane-yi	1
peynir	peynir	3
peynirini	peynir-i-ni	3
picaması	picama-sı	1
pijama	pijama	3
pijamaları	pijama-lar-ı	1
pijaman	pijam-an	1
pijamasını	pijama-sı-nı	1
pikap	pikap	1
piknik	piknik	1
pil	pil	1
pilav	pilav	2
pili	pili	1
pilli	pil-li	8
pilotu	pilot-u	1
piraye	piraye	9
pirayeciğim	piraye-ciğ-im	1
pirayelerde	piraye-ler-de	1
pirayenin	piraye-nin	3
pirayeye	piraye-ye	1
pirayeyi	piraye-yi	2
pirzola	pirzola	2
pis	pis	1
pisi	pisi	4
pisiler	pisi-ler	1
pisin	pis-in	1
pislik	pis-lik	1
pislikleri	pis-lik-ler-i	1
piyano	piyano	3
pişer	piş-er	2
pişirdi	piş-ir-di	2
pişirdim	piş-ir-di-m	1
pişirebilir	piş-ir-ebil-ir	1
pişirecek	piş-ir-ecek	1
pişireceksin	piş-ir-ecek-sin	3
pişirelim	piş-ir-e-li-m	1
pişirilir	piş-ir-il-ir	2
pişirir	piş-ir-ir	1
pişiririz	piş-ir-ir-iz	1
pişirirsin	piş-ir-ir-sin	2
pişiriyor	piş-ir-iyor	12
pişiriyorsun	piş-ir-iyor-sun	2
pişiriyorsunuz	piş-ir-iyor-sunuz	1
pişirmiyor	piş-ir-mi-yor	2
pişirmiştik	piş-ir-miş-ti-k	2
pişmiş	piş-miş	2
plak	plak	4
polis	polis	6
polonezköye	polonez+köy-e	1
pompayla	pompa-yla	1
poposunu	popo-su-nu	1
portakal	portakal	3
poğaça	poğaça	3
puanı	puan-ı	1
pütürük	pütürük	2
pınarı	pınar-ı	1
pırasa	pırasa	1
radyo	radyo	2
radyoyu	radyo-yu	1
rahat	rahat	1
rahatlıkla	rahat-lık-la	1
rahatsız	rahat-sız	1
rahim	rahim	1
ramazan	ramazan	3
ranzalı	ranza-lı	1
rastlamış	rastla-mış	1
rengi	reng-i	7
rengini	reng-i-ni	4
renk	renk	17
renkler	renk-ler	1
renkleri	renk-ler-i	1
renkti	renk-ti	2
resim	resim	83
resimde	resim-de	3
resimler	resim-ler	3
resmi	resmi	20
resmini	resm-i-ni	6
resmiymiş	resmi-ymiş	1
rezalet	rezalet	1
rezil	rezil	1
rica	rica	1
ruj	ruj	2
rüya	rüya	3
rüyamda	rüya-m-da	1
rüyamdaydın	rüya-m-da-ydı-n	1
rüyanda	rüya-n-da	1
saat	saat	8
saati	saat-i	2
saatin	saat-in	3
saatle	saat-le	1
sabah	sabah	21
sabahattin	sabahattin	1
sabahları	sabahları	5
sabahleyin	sabahleyin	15
sabahtan	sabah-tan	1
sabun	sabun	7
sabunu	sabun-u	1
sahi	sahi	44
sahibi	sahib-i	1
sahici	sahici	5
sahiden	sahiden	3
saime	saime	4
saimeyi	saime-yi	1
sakladın	sakla-dı-n	1
saklama	sakla-ma	1
saklamaya	sakla-ma-ya	1
saklambaç	saklambaç	3
saklanacak	sakla-n-acak	1
saklandı	sakla-n-dı	1
saklarsın	sakla-r-sın	1
saklarız	sak-lar-ız	1
saklıyor	saklı-yor	1
sakın	sakın	1
sakız	sakız	1
sallanıyorsun	salla-n-ıyor-sun	1
sallanıyorsunuz	salla-n-ıyor-sunuz	1
salı	salı	1
salıncak	salıncak	1
salıncaklar	salıncak-lar	2
salıncaklara	salıncak-lar-a	2
salıncakları	salıncak-lar-ı	2
salıncağa	salıncağ-a	1
salıncağı	salıncağ-ı	1
salıncağın	salıncağ-ın	1
san	san	1
sana	san-a	219
sanat	sanat	1
sandalyelerin	sandalye-ler-in	1
sandviçi	sandviç-i	1
santim	santim	1
sapı	sap-ı	3
sapını	sap-ı-nı	1
sardım	sar-dı-m	1
sarhoş	sarhoş	1
sarı	sarı	5
sarılıp	sar-ıl-ıp	1
sarılıyorlar	sar-ıl-ıyor-lar	1
sarıyor	sar-ıyor	1
sarıyorum	sar-ıyor-um	1
say	say	12
saysana	say-sana	2
sayı	sayı	2
sayıyorsun	say-ıyor-sun	1
saç	saç	1
saçları	saç-lar-ı	5
saçlarım	saç-lar-ım	2
saçlarımı	saç-lar-ım-ı	2
saçların	saç-lar-ın	6
saçlarına	saç-lar-ı-na	1
saçlarını	saç-lar-ı-nı	3
saçlı	saç-lı	1
saçı	saçı	1
saçım	saç-ım	1
saçımı	saç-ım-ı	1
saçın	saç-ın	1
saçına	saç-ı-na	1
saçını	saç-ı-nı	9
sağa	sağ-a	1
sağdın	sağ-dı-n	1
sağlam	sağlam	1
sağılır	sağ-ıl-ır	1
sebebi	sebeb-i	1
sebep	sebep	1
sefa	sefa	1
sefer	sefer	2
sefere	sefer-e	1
sehpa	sehpa	1
sek	sek	2
seksekten	seksek-ten	1
selam	selam	2
selim	selim	13
selimciğim	selim-ciğ-im	4
sema	sema	2
sen	sen	847
sende	sen-de	3
senden	sen-den	14
sene	sene	5
seni	sen-i	54
senin	sen-in	297
seninki	sen-in-ki	1
seninle	sen-inle	13
senle	sen-le	41
sepet	sepet	2
sepeti	sepet-i	1
serap	serap	1
serdim	ser-di-m	2
serçe	serçe	2
ses	ses	10
sesi	ses-i	4
sesin	ses-in	5
sesini	ses-i-ni	8
sesle	ses-le	3
sesler	ses-ler	2
sessiz	ses-siz	1
sev	sev	1
sevdi	sev-di	1
sevdim	sev-di-m	1
sevdin	sev-di-n	10
sevdiği	sev-diğ-i	1
sevdiğin	sev-diğ-in	1
sever	sev-er	13
severim	sev-er-im	5
severler	sev-er-ler	2
seversin	sev-er-sin	3
sevilir	sev-il-ir	1
sevince	sevinc-e	1
sevindin	sevin-di-n	2
seviyor	sev-iyor	65
seviyordun	sev-iyor-du-n	1
seviyorlar	sev-iyor-lar	2
seviyorsun	sev-iyor-sun	28
seviyorum	sev-iyor-um	2
sevmedim	sev-me-di-m	1
sevmem	sev-me-m	3
sevmez	sev-me-z	2
sevmezler	sev-me-z-ler	1
sevmezsin	sev-me-z-sin	3
sevmiyor	sev-mi-yor	7
sevmiyorlar	sev-mi-yor-lar	1
sevmiyorsun	sev-mi-yor-sun	3
sevsin	sev-sin	1
seyrederlerken	seyred-er-ler-ken	1
seyrediyor	seyred-iyor	7
seyrediyordu	seyred-iyor-du	1
seyrediyorlar	seyred-iyor-lar	3
seyrediyorsun	seyred-iyor-sun	2
seyrediyorsunuz	seyred-iyor-sunuz	2
seyretsinler	seyret-sinler	2
seyrettin	seyret-ti-n	5
seyrettiniz	seyret-ti-niz	1
sibel	sibel	1
sigara	sigara	4
sigaramı	sigara-m-ı	2
sil	sil	1
silafonun	silafon-un	1
silelim	sil-e-li-m	1
siler	sil-er	2
silerken	sil-er-ken	1
silgi	silgi	1
silgisi	silgi-si	2
silindir	silindir	1
silindiri	silindir-i	3
siliyor	sil-iyor	2
siliyorsun	sil-iyor-sun	1
siliyorsunuz	sil-iyor-sunuz	1
silme	silme	4
silofonu	silofon-u	1
simidi	simid-i	3
simidin	simid-in	8
simit	simit	6
simitsiz	simit-siz	2
simtan	simtan	1
simter	simter	1
sinan	sinan	10
sinana	sinan-a	1
sinanla	sinan-la	1
sinanı	sinan-ı	3
sinanın	sinan-ın	1
sincaba	sincab-a	1
sincabı	sincab-ı	1
sincap	sincap	9
sinekler	sinek-ler	1
sinema	sinema	1
sinemada	sinema-da	8
sinemanın	sinema-nın	2
sineması	sinema-sı	3
sinemasında	sinema-sı-nda	1
sinemasıymış	sinema-sı-ymış	1
sinemaya	sinema-ya	14
sinemayı	sinema-yı	1
sineği	sineğ-i	1
siyah	siyah	1
siz	siz	35
sizde	siz-de	2
size	siz-e	9
sizi	siz-i	2
sizin	siz-in	50
slobin	slobin	1
slobine	slobin-e	1
soba	soba	2
sobayı	soba-yı	2
sofrada	sofra-da	1
sok	sok	4
sokabilirsin	sok-abil-ir-sin	1
sokacaksın	sok-acak-sın	2
sokak	sokak	3
sokaklara	sokak-lar-a	2
sokaklardan	sokak-lar-dan	1
sokakta	sokak-ta	20
sokarız	sok-ar-ız	2
sokağa	sokağ-a	10
sokmak	sok-mak	1
soktun	sok-tu-n	1
sokuyordun	sok-uyor-du-n	2
sokuyorsun	sok-uyor-sun	1
sola	sol-a	1
solucan	solucan	2
son	son	2
sonra	sonra	159
sonradan	sonradan	1
sopa	sopa	1
sopalar	sopa-lar	1
sopalıyorlar	sopalı-yor-lar	1
sopayla	sopa-yla	2
sor	sor	1
soracam	sor-a-ca-m	1
soracağım	sor-acağ-ım	2
soralım	sor-a-lı-m	2
sorayım	sor-a-yım	2
sorduklarıma	sor-duk-lar-ım-a	1
sordum	sor-du-m	2
sordun	sor-du-n	1
sorduğuma	sor-duğ-um-a	1
sormak	sor-mak	1
sorsana	sor-sana	2
soruyor	sor-uyor	3
soruyorum	sor-uyor-um	8
soy	soy	1
soyadı	soyad-ı	2
soyadın	soyad-ın	3
soyunuyor	soyun-uyor	1
soyunuyoruz	soyun-uyor-uz	3
soyuyorsun	soy-uyor-sun	1
soğuk	soğuk	4
soğukta	soğuk-ta	1
su	su	61
sual	sual	1
sucuk	sucuk	2
sucuğu	sucuğ-u	1
suda	su-da	4
sudan	su-dan	6
sular	su-lar	1
sulu	su-lu	2
suna	suna	1
suratı	surat-ı	1
susamış	susa-mış	2
susarlarda	sus-ar-lar-da	1
susuz	su-suz	1
suya	su-ya	1
suyla	su-yla	1
suyu	su-yu	9
suyun	su-yun	4
suzan	suzan	1
suzana	suzan-a	1
söktün	sök-tü-n	1
söndükten	sön-dük-ten	1
sönünce	sön-ünce	1
sönüyor	sön-üyor	2
sönüyormuş	sön-üyor-muş	2
söyle	söyle	142
söyledi	söyle-di	3
söylediğini	söyle-diğ-i-ni	1
söylemedin	söyle-me-di-n	1
söylemek	söyle-mek	1
söylemez	söyle-me-z	1
söylemiyor	söyle-mi-yor	1
söylemiyorsun	söyle-mi-yor-sun	1
söylemiş	söyle-miş	2
söylemiştim	söyle-miş-ti-m	1
söyler	söyle-r	7
söyleriz	söyle-r-iz	1
söylerken	söyle-r-ken	1
söylerler	söyle-r-ler	1
söylesene	söyle-sene	8
söylesenize	söyle-senize	1
söylet	söyle-t	2
söyletirim	söyle-t-ir-im	1
söyleyebilirler	söyle-yebil-ir-ler	1
söyleyecek	söyle-yecek	4
söyleyeceksin	söyle-yecek-sin	5
söyleyeceğim	söyle-yeceğ-im	2
söyleyelim	söyle-ye-li-m	5
söyleyeyim	söyle-ye-yim	5
söylüyor	söylü-yor	3
söylüyorlar	söylü-yor-lar	2
söylüyorsun	söylü-yor-sun	1
söylüyorum	söylü-yor-um	1
söz	söz	1
sünnetçiler	sünnet-çi-ler	1
süpürdü	süpür-dü	1
süpürge	süpürge	2
süpürgeyle	süpürge-yle	1
süpürmüyorlar	süpür-mü-yor-lar	1
süpürür	süpür-ür	7
süpürürler	süpür-ür-ler	1
süpürürsün	süpür-ür-sün	1
süpürürüz	süpür-ür-üz	1
süpürüyor	süpür-üyor	23
süpürüyorlar	süpür-üyor-lar	3
süpürüyorsun	süpür-üyor-sun	1
sürdü	sür-dü	4
sürdün	sür-dü-n	1
sürdünüz	sür-dü-nüz	1
sürer	sür-er	2
sürersek	sür-er-se-k	1
sürersem	sür-er-se-m	1
sürü	sürü	4
sürünce	sür-ünce	1
sürüp	sür-üp	1
sürüyor	sür-üyor	20
sürüyorsun	sür-üyor-sun	4
süs	süs	1
süslendi	süsle-n-di	2
süsleneyim	süsle-n-e-yim	2
süslenir	süsle-n-ir	37
süslenirken	süsle-n-ir-ken	2
süsleniyor	süsle-n-iyor	43
süslenmesini	süs-len-me-si-ni	2
süslenmiyor	süsle-n-mi-yor	2
süslüyor	süslü-yor	3
süt	süt	20
sütsüz	süt-süz	3
sütü	süt-ü	3
sütünü	süt-ü-nü	2
sıcak	sıcak	3
sık	sık	6
sıktın	sık-tı-n	1
sıkı	sıkı	1
sıkıldın	sıkıl-dı-n	4
sıkıyor	sık-ıyor	1
sıkıştı	sık-ış-tı	2
sıkışırsa	sık-ış-ır-sa	1
sınıfa	sınıf-a	1
sınıfta	sınıf-ta	3
sıra	sıra	1
sırada	sıra-da	1
sıraya	sıra-ya	1
sırtına	sırt-ı-na	1
sıvaşıyor	sıvaş-ıyor	2
sığar	sığ-ar	3
sığmaz	sığ-ma-z	1
sığıyor	sığ-ıyor	1
ta	ta	3
tabak	tabak	2
tabaklar	tabakla-r	1
tabakları	tabak-lar-ı	1
tabanca	tabanca	2
tabancaları	tabanca-lar-ı	1
tabancanın	tabanca-nın	3
tabancası	tabanca-sı	3
tabancayla	tabanca-yla	1
tabağın	tabağ-ın	1
tabii	tabii	102
tabla	tabla	1
tablayı	tabla-yı	2
tabışkana	tabışkan-a	1
tabışkanla	tabışkan-la	2
tadı	tad-ı	1
tadını	tad-ı-nı	2
tahlip	tahlip	1
tahmin	tahmin	1
tahta	tahta	3
tahtalar	tahta-lar	1
tahtalarla	tahta-lar-la	1
tahtaların	tahta-lar-ın	1
tahtanın	tahta-nın	2
tahtayla	tahta-yla	1
tahtayı	tahta-yı	3
tak	tak	8
takabildin	tak-abil-di-n	1
takabilir	tak-abil-ir	1
takabiliyor	tak-abil-iyor	1
takalım	taka-lı-m	2
takamadım	tak-a-ma-dı-m	2
takayım	tak-a-yım	6
takmadın	tak-ma-dı-n	1
takmak	tak-mak	2
takmam	takma-m	1
takmazsan	tak-ma-z-sa-n	1
takmış	tak-mış	1
taksi	taksi	1
taksimde	taksim-de	2
taksimdeki	taksim-de-ki	1
taksimden	taksim-den	1
taksın	tak-sın	1
taktı	tak-tı	2
taktılar	tak-tı-lar	1
taktığın	tak-tığ-ın	2
takıcam	takı-ca-m	2
takılıyor	tak-ıl-ıyor	1
takımdan	takım-dan	2
takımdansınız	tak-ım-dan-sınız	1
takımlar	takım-lar	1
takımı	takım-ı	1
takıp	tak-ıp	1
takıyor	tak-ıyor	6
takıyorsun	tak-ıyor-sun	8
takıyorum	tak-ıyor-um	1
tam	tam	1
tamam	tamam	17
tamamlanır	tamamla-n-ır	1
tamir	tamir	18
tamirci	tamir-ci	1
tamire	tamir-e	3
tan	tan	12
tancığım	tan-cığ-ım	2
tandoğan	tandoğan	3
tane	tane	77
tanesi	tane-si	4
tanesine	tane-si-ne	1
tanesini	tane-si-ni	1
tank	tank	5
tankı	tank-ı	2
tankın	tank-ın	1
tansele	tansel-e	1
tanıdığım	tanı-dığ-ım	2
tanımıyorum	tanı-mı-yor-um	3
tanıyor	tanı-yor	3
tanıyorsun	tanı-yor-sun	1
taraf	taraf	1
tarafa	taraf-a	7
tarafta	taraf-ta	3
tarafına	taraf-ı-na	1
tarar	tara-r	2
tarif	tarif	11
tarkanlar	tarkan-lar	1
tartacaksın	tart-acak-sın	1
tartıyor	tart-ıyor	4
tarıyor	tarı-yor	3
tatil	tatil	1
tatlı	tatlı	4
tatlısı	tatlı-sı	1
taunusu	taunus-u	1
taunusuyla	taunus-u-yla	1
tavana	tavan-a	1
tavla	tavla	4
tavuk	tavuk	1
tavuklarını	tavuk-lar-ı-nı	1
tavuğu	tavuğ-u	2
tavuğun	tavuğ-un	3
tavşan	tavşan	8
tavşanı	tavşan-ı	1
tayfuna	tayfun-a	1
tayfunla	tayfun-la	1
tayfunu	tayfun-u	1
tayyarlara	tayyar-lar-a	1
tayyarın	tayyar-ın	2
taze	taze	1
taş	taş	6
taşla	taş-la	1
taşlar	taş-lar	2
taşı	taş-ı	1
taşımıyorsun	taşı-mı-yor-sun	2
taşın	taş-ın	1
taşındı	taşı-n-dı	1
taşınıyorum	taşın-ıyor-um	1
taşır	taşı-r	2
taşırlar	taşı-r-lar	2
taşısın	taşı-sın	2
taşıyor	taşı-yor	4
tehlikeli	tehlike-li	1
tek	tek	4
tekerlekleri	tekerlek-ler-i	2
tekerleği	tekerleğ-i	2
tekir	tekir	1
tekme	tekme	1
tekrar	tekrar	2
telefon	telefon	2
telefonda	telefon-da	1
telefonun	telefon-un	1
televizyon	televizyon	13
televizyonda	televizyon-da	5
televizyonu	televizyon-u	2
televizyonun	televizyon-un	4
televizyonunuz	televizyon-unuz	1
temiz	temiz	2
temizledi	temizle-di	2
temizledin	temizle-di-n	2
temizlemek	temiz-le-mek	1
temizlenir	temizle-n-ir	1
temizler	temizle-r	10
temizlerken	temizle-r-ken	1
temizlerler	temizle-r-ler	2
temizlersin	temizle-r-sin	2
temizleyeceğim	temizle-yeceğ-im	1
temizliyor	temizli-yor	71
temizliyorsun	temizli-yor-sun	5
teneke	teneke	1
tepelerden	tepe-ler-den	1
tepelerin	tepe-ler-in	1
tepeme	tep-e-me	1
tepesini	tepe-si-ni	3
terazini	terazi-n-i	1
terazisi	terazi-si	1
terbiyeli	terbiye-li	1
terbiyesiz	terbiye-siz	6
terbiyesizlik	terbiye-siz-lik	1
terbiyesizliklerinden	terbiye-siz-lik-leri-nden	1
tereyağında	tereyağ-ı-nda	1
terlik	terlik	2
terliklerini	terlik-ler-i-ni	1
ters	ters	10
tersanede	tersane-de	2
tertemiz	tertemiz	1
tetik	tetik	1
teybe	teyb-e	10
teybi	teyb-i	8
teybim	teyb-im	1
teybin	teyb-in	2
teyp	teyp	12
teyze	teyze	19
teyzeler	teyze-ler	2
teyzen	teyze-n	6
teyzenin	teyze-nin	5
teyzesi	teyze-si	1
teyzesiyle	teyze-si-yle	1
teyzeye	teyze-ye	12
teyzeyi	teyze-yi	3
teşekkür	teşekkür	4
tilki	tilki	2
tilkiyi	tilki-yi	9
time	tim-e	1
tiniz	tin-iz	1
tiyatroya	tiyatro-ya	1
tok	tok	1
toka	toka	1
tokaları	toka-lar-ı	1
tokam	toka-m	1
tokum	tok-um	1
tombul	tombul	1
top	top	30
topacı	topac-ı	1
topal	topal	3
topla	top-la	4
topladım	topla-dı-m	1
toplar	top-lar	3
topları	top-lar-ı	1
topların	top-lar-ın	1
toplayalım	topla-ya-lı-m	1
toplayım	topla-yım	1
topluyor	toplu-yor	1
topluyorum	toplu-yor-um	1
toprak	toprak	1
toprağı	toprağ-ı	1
topu	top-u	26
topun	top-un	31
topunla	top-un-la	2
topunu	top-u-nu	9
topuz	topuz	4
tos	tos	1
tozu	toz-u	2
trafik	trafik	5
traktör	traktör	19
traktörü	traktör-ü	2
traktörün	traktör-ün	5
traş	traş	3
tren	tren	2
treni	tren-i	1
tuhaf	tuhaf	1
tulumba	tulumba	1
tulumun	tulum-un	1
tuncaya	tunca-ya	1
turuncu	turuncu	1
tut	tut	2
tutacağım	tut-acağ-ım	1
tutalım	tut-a-lı-m	1
tutar	tutar	2
tutarsan	tutar-sa-n	1
tutarım	tut-ar-ım	1
tutmaya	tut-ma-ya	3
tutmuyor	tut-mu-yor	2
tutmuş	tut-muş	1
tutsun	tut-sun	1
tuttu	tut-tu	2
tuttum	tut-tu-m	3
tuttun	tut-tu-n	3
tutuyor	tut-uyor	4
tutuyorlar	tut-uyor-lar	1
tutuyorsun	tut-uyor-sun	1
tutuyorsunuz	tut-uyor-sunuz	1
tutuyorum	tut-uyor-um	1
tutuşup	tutuş-up	1
tuvalet	tuvalet	1
tuz	tuz	3
tuzlu	tuz-lu	1
tuzsuz	tuz-suz	1
tüfek	tüfek	2
tüfeği	tüfeğ-i	4
tüfeğin	tüfeğ-in	2
tüfeğini	tüfeğ-i-ni	2
tülaya	tülay-a	1
türkan	türkan	5
türkçeye	türkçe-ye	1
türkü	türkü	1
türlü	türlü	1
tüyleri	tüy-ler-i	1
tüylerini	tüy-ler-i-ni	1
tık	tık	2
tıkma	tık-ma	1
tıktığın	tık-tığ-ın	1
tırmaladı	tırmala-dı	7
tırmalamazlar	tırmala-ma-z-lar	2
tırmalamıyor	tırmala-mı-yor	1
tırmalamış	tırmala-mış	2
tırmalanır	tırmala-n-ır	1
tırmalar	tırmala-r	54
tırmalarlar	tırmala-r-lar	3
tırmalasın	tırmala-sın	2
tırmalıyor	tırmalı-yor	8
tırman	tırman	2
tırmandı	tırman-dı	1
tırmandın	tırman-dı-n	1
tırmanır	tırman-ır	2
tırmanıyor	tırman-ıyor	1
tırnakları	tırnak-lar-ı	1
tırnakların	tırnak-lar-ın	1
tırnaklarına	tırnak-lar-ı-na	2
tırnaklarında	tırnak-lar-ı-nda	1
tırnaklarını	tırnak-lar-ı-nı	12
tırnaklarının	tırnak-lar-ı-nın	1
tırnağı	tırnağ-ı	1
ucu	uc-u	1
ucunu	uc-u-nu	1
ufacık	ufacık	1
ufak	ufak	1
ukalam	ukala-m	1
uludağa	ulu+dağ-a	1
uludağda	ulu+dağ-da	2
uludağı	ulu+dağ-ı	1
uluyor	ulu-yor	1
unutmadın	unut-ma-dı-n	1
unuttuk	unut-tu-k	1
unuttun	unut-tu-n	1
utanmasana	utan-ma-sana	1
uyanmadılar	uyan-ma-dı-lar	1
uyanırken	uyan-ır-ken	2
uyanıyorlar	uyan-ıyor-lar	1
uydur	uydur	1
uyduruyorsun	uydur-uyor-sun	2
uyku	uyku	2
uykum	uyku-m	1
uykumuzu	uyku-muz-u	2
uykun	uyku-n	2
uykunu	uyku-n-u	1
uykusu	uyku-su	4
uykusuna	uyku-su-na	1
uyudu	uyu-du	3
uyudum	uyu-du-m	1
uyudun	uyu-du-n	6
uyumayacak	uyu-ma-yacak	1
uyumaz	uyu-ma-z	1
uyumuyor	uyu-mu-yor	2
uyumuş	uyu-muş	1
uyur	uyu-r	51
uyurdun	uyu-r-du-n	5
uyurken	uyu-r-ken	1
uyurlar	uyu-r-lar	5
uyursak	uyu-r-sa-k	2
uyursan	uyu-r-sa-n	1
uyursun	uyu-r-sun	6
uyusun	uyu-sun	1
uyusunlar	uyu-sunlar	2
uyuyacak	uyu-yacak	1
uyuyacaklar	uyu-yacak-lar	1
uyuyacakmış	uyu-yacak-mış	1
uyuyor	uy-uyor	27
uyuyordu	uy-uyor-du	1
uyuyorlar	uy-uyor-lar	7
uyuyormuş	uy-uyor-muş	2
uyuyorsun	uy-uyor-sun	6
uyuyorum	uy-uyor-um	1
uzak	uzak	1
uzakta	uzak-ta	2
uzaktan	uzak-tan	1
uzamış	uza-mış	1
uzamışlar	uza-mış-lar	1
uzağa	uzağ-a	3
uzun	uzun	4
uzunmuş	uzun-muş	1
uç	uç	1
uçabiliyor	uç-abil-iyor	1
uçak	uçak	13
uçaklar	uçak-lar	1
uçamıyor	uç-a-mı-yor	1
uçan	uç-an	4
uçar	uç-ar	41
uçarken	uç-ar-ken	1
uçarlar	uç-ar-lar	9
uçağa	uçağ-a	2
uçağı	uçağ-ı	2
uçağın	uçağ-ın	1
uçağını	uçağ-ı-nı	1
uçma	uç-ma	1
uçmaz	uç-ma-z	1
uçuyor	uç-uyor	14
uçuyorlar	uç-uyor-lar	1
uğrayalım	uğra-ya-lı-m	1
uğraşma	uğraş-ma	1
uğraşıyorum	uğraş-ıyor-um	1
uğur	uğur	1
vahide	vahide	15
vakit	vakit	1
vapur	vapur	11
vapura	vapur-a	5
vapurda	vapur-da	1
vapurdan	vapur-dan	1
vapurla	vapur-la	1
vapurlar	vapur-lar	2
vapuru	vapur-u	3
vapurun	vapur-un	5
vapuruna	vapur-u-na	3
var	var	580
vardı	var-dı	13
varmış	var-mış	22
varsa	var-sa	1
ve	ve	2
veli	veli	1
ver	ver	33
verdi	ver-di	40
verdim	ver-di-m	2
verdin	ver-di-n	4
verdiğin	ver-diğ-in	1
verebilirim	ver-ebil-ir-im	1
verecek	ver-ecek	2
verecekler	ver-ecek-ler	1
vereceksin	ver-ecek-sin	1
verecem	ver-e-ce-m	6
vereceğim	ver-eceğ-im	11
verelim	vere-li-m	2
veremem	ver-e-me-m	1
veremeyiz	ver-e-me-yiz	1
vereyim	ver-e-yim	36
verir	ver-ir	9
veririm	ver-ir-im	8
veririz	ver-ir-iz	1
verirsen	ver-ir-se-n	1
verirsin	ver-ir-sin	2
veriyim	veri-yim	1
veriyor	ver-iyor	8
veriyorlar	ver-iyor-lar	2
veriyorsun	ver-iyor-sun	2
veriyorum	ver-iyor-um	3
veriş	ver-iş	1
verişte	ver-iş-te	1
vermedi	ver-me-di	3
vermem	ver-me-m	5
vermemiş	ver-me-miş	1
vermesi	ver-me-si	1
vermeyeceğim	ver-me-yeceğ-im	1
vermiyor	ver-mi-yor	3
vermiyorlar	ver-mi-yor-lar	2
vermiyorsun	ver-mi-yor-sun	4
vermiş	ver-miş	1
vermişler	ver-miş-ler	1
vermiştim	ver-miş-ti-m	1
versem	ver-se-m	1
versene	ver-sene	6
vida	vida	1
virgül	virgül	1
vişne	vişne	1
volkswageni	volkswagen-i	1
vuracaksın	vur-acak-sın	1
vurmuyor	vur-mu-yor	1
vurmuş	vur-muş	1
vurursa	vur-ur-sa	3
vururum	vur-ur-um	1
vuruyor	vur-uyor	1
vuruyorlar	vur-uyor-lar	1
ya	ya	45
yaban	yaban	2
yakacam	yak-a-ca-m	1
yakaladı	yakala-dı	1
yakalarlar	yakala-r-lar	1
yakalayacak	yakala-yacak	1
yaklaştı	yaklaş-tı	1
yakmıyor	yak-mı-yor	1
yakmıyoruz	yak-mı-yor-uz	1
yakın	yakın	2
yakında	yakın-da	2
yakıyor	yak-ıyor	3
yakışacak	yakış-acak	1
yakışmış	yakış-mış	2
yakışıyor	yakış-ıyor	1
yalan	yalan	5
yalasın	yala-sın	1
yalnız	yalnız	11
yalovada	yalova-da	1
yalovadan	yalova-dan	1
yalovaya	yalova-ya	2
yalçınla	yalçın-la	2
yan	yan	3
yana	yana	1
yanacakmış	yan-acak-mış	1
yanaklarına	yanak-lar-ı-na	1
yanar	yan-ar	3
yandın	yan-dı-n	2
yangın	yangın	1
yani	yani	7
yanmıyormuş	yan-mı-yor-muş	1
yanmış	yan-mış	2
yanyana	yanyana	2
yanıma	yan-ım-a	8
yanına	yan-ı-na	10
yanında	yan-ı-nda	4
yanındaki	yan-ı-nda-ki	1
yanındakinin	yan-ı-nda-ki-nin	1
yanıyor	yan-ıyor	8
yanıyordu	yan-ıyor-du	1
yap	yap	61
yapabilir	yap-abil-ir	7
yapabiliriz	yap-abil-ir-iz	1
yapabilirler	yap-abil-ir-ler	2
yapabiliyor	yap-abil-iyor	1
yapacak	yap-acak	7
yapacaklar	yap-acak-lar	7
yapacaklarmış	yap-acak-lar-mış	2
yapacakmış	yap-acak-mış	3
yapacaksan	yap-acak-sa-n	1
yapacaksın	yap-acak-sın	45
yapacaksınız	yap-acak-sınız	5
yapacaktı	yap-acak-tı	1
yapacağım	yap-acağ-ım	1
yapacağız	yap-acağ-ız	19
yapalım	yap-a-lı-m	20
yapamayacaksın	yap-a-ma-yacak-sın	1
yapamaz	yap-a-ma-z	1
yapamazsın	yap-a-ma-z-sın	1
yapamıyor	yap-a-mı-yor	1
yapan	yap-an	1
yapar	yap-ar	218
yapardı	yap-ar-dı	1
yaparken	yap-ar-ken	2
yaparlar	yap-ar-lar	62
yaparsam	yap-ar-sa-m	1
yaparsan	yap-ar-sa-n	4
yaparsın	yap-ar-sın	40
yaparsınız	yap-ar-sınız	2
yaparım	yap-ar-ım	3
yaparız	yap-ar-ız	2
yapayım	yap-a-yım	6
yapma	yapma	10
yapmadı	yap-ma-dı	1
yapmak	yap-mak	10
yapmamı	yapma-m-ı	1
yapmasın	yap-ma-sın	1
yapmasını	yapma-sı-nı	2
yapmaya	yapma-ya	1
yapmayacak	yap-ma-yacak	1
yapmayacaksın	yap-ma-yacak-sın	1
yapmayacan	yap-ma-ya-ca-n	1
yapmayacağım	yap-ma-yacağ-ım	1
yapmaz	yap-ma-z	1
yapmazsın	yap-ma-z-sın	1
yapmıyor	yap-mı-yor	1
yapmıyorsun	yap-mı-yor-sun	1
yapmış	yap-mış	23
yapmışlar	yap-mış-lar	2
yapmışsın	yap-mış-sın	1
yaprak	yaprak	1
yapraklar	yaprak-lar	1
yapsak	yap-sa-k	1
yapsana	yap-sana	3
yapsın	yap-sın	6
yaptı	yap-tı	36
yaptık	yap-tı-k	11
yaptılar	yap-tı-lar	10
yaptım	yap-tı-m	9
yaptın	yap-tı-n	78
yaptınız	yap-tı-nız	22
yaptırdılar	yap-tır-dı-lar	1
yaptırmaya	yap-tır-ma-ya	1
yaptığı	yap-tığ-ı	1
yapıcan	yapı-ca-n	2
yapılmaz	yap-ıl-ma-z	1
yapılmış	yap-ıl-mış	2
yapılır	yap-ıl-ır	8
yapılıyor	yap-ıl-ıyor	2
yapın	yapı-n	1
yapınca	yap-ınca	1
yapıyor	yap-ıyor	291
yapıyordu	yap-ıyor-du	7
yapıyorduk	yap-ıyor-du-k	2
yapıyordun	yap-ıyor-du-n	2
yapıyorlar	yap-ıyor-lar	64
yapıyorlardı	yap-ıyor-lar-dı	4
yapıyorlarmış	yap-ıyor-lar-mış	2
yapıyormuş	yap-ıyor-muş	12
yapıyorsan	yap-ıyor-sa-n	1
yapıyorsun	yap-ıyor-sun	120
yapıyorsunuz	yap-ıyor-sunuz	33
yapıyorum	yap-ıyor-um	1
yapıyoruz	yap-ıyor-uz	3
yapışkan	yapışkan	2
yapışkanı	yapışkan-ı	4
yapışmadı	yapış-ma-dı	1
yapışmıyor	yapış-mı-yor	1
yapıştı	yapış-tı	2
yapıştıracak	yapış-tır-acak	2
yapıştıracağız	yapış-tır-acağ-ız	1
yapıştırırız	yapış-tır-ır-ız	2
yara	yara	6
yaralanacak	yarala-n-acak	1
yaralarına	yara-lar-ı-na	1
yaramaz	yara-ma-z	1
yaramazlık	yaramaz-lık	5
yarar	yarar	1
yardım	yardım	9
yarılmış	yar-ıl-mış	1
yarın	yarın	5
yarıyor	yarı-yor	6
yastığın	yastığ-ın	1
yatacaksın	yat-acak-sın	2
yatak	yatak	4
yatakta	yatak-ta	2
yatalım	yat-a-lı-m	1
yatar	yat-ar	4
yatarak	yat-arak	1
yatarken	yat-ar-ken	1
yatağı	yatağ-ı	3
yatağın	yatağ-ın	6
yatağında	yatağ-ı-nda	1
yatağını	yatağ-ı-nı	1
yatmak	yat-mak	1
yatmayacak	yat-ma-yacak	1
yatmayacaksın	yat-ma-yacak-sın	1
yatmayacağım	yat-ma-yacağ-ım	1
yatmıyor	yat-mı-yor	1
yatmıyorum	yat-mı-yor-um	1
yatsınlar	yat-sınlar	1
yattı	yat-tı	3
yatır	yat-ır	5
yatırdın	yat-ır-dı-n	1
yatırıyor	yat-ır-ıyor	3
yatırıyorsun	yat-ır-ıyor-sun	1
yatıyor	yat-ıyor	17
yatıyordun	yat-ıyor-du-n	3
yatıyorlar	yat-ıyor-lar	4
yatıyorsun	yat-ıyor-sun	9
yatıyorsunuz	yat-ıyor-sunuz	4
yatıyoruz	yat-ıyor-uz	1
yavaş	yavaş	6
yavru	yavru	3
yavrucuğum	yavru-cuğ-um	1
yavruları	yavru-lar-ı	8
yavrularını	yavru-lar-ı-nı	4
yavrum	yavru-m	4
yavrusu	yavru-su	2
yavrusunu	yavru-su-nu	1
yaz	yaz	5
yazabilir	yaz-abil-ir	3
yazalım	yaz-a-lı-m	1
yazarsın	yaz-ar-sın	3
yazdın	yaz-dı-n	2
yazma	yazma	1
yazmıyor	yaz-mı-yor	2
yazsana	yaz-sana	1
yazı	yazı	8
yazık	yazık	32
yazıldı	yaz-ıl-dı	1
yazın	yazın	3
yazıyor	yaz-ıyor	11
yazıyorsun	yaz-ıyor-sun	6
yazıyorum	yaz-ıyor-um	1
yazıyı	yazı-yı	1
yağ	yağ	2
yağlı	yağ-lı	1
yağmur	yağmur	3
yağmurluk	yağmurluk	1
yağı	yağı	2
yağınca	yağ-ınca	2
yağıyor	yağ-ıyor	1
yaşamak	yaşa-mak	1
yaşar	yaşa-r	3
yaşında	yaş-ı-nda	9
yaşındasın	yaş-ı-nda-sın	5
yaşındaydın	yaş-ı-nda-ydı-n	1
ye	ye	3
yedi	yedi	8
yediler	ye-di-ler	5
yedim	ye-di-m	3
yedin	ye-di-n	19
yediniz	ye-di-niz	5
yedinse	ye-di-n-se	1
yedirirdik	ye-dir-ir-di-k	1
yediriyor	ye-dir-iyor	1
yediriyorsun	ye-dir-iyor-sun	1
yem	yem	2
yeme	yem-e	1
yemedin	ye-me-di-n	6
yemediniz	ye-me-di-niz	1
yemek	yemek	66
yemekler	yemek-ler	2
yemeklerden	yemek-ler-den	1
yemekleri	yemek-ler-i	5
yemeklik	yemek-lik	2
yemekte	yemek-te	2
yememişsin	ye-me-miş-sin	1
yemesin	ye-me-sin	2
yemesini	ye-me-si-ni	1
yemeye	ye-me-ye	2
yemeyi	ye-me-yi	1
yemez	ye-me-z	11
yemezler	ye-me-z-ler	2
yemeğe	yemeğ-e	1
yemeği	yemeğ-i	11
yemeğimizi	yemeğ-imiz-i	1
yemeğiymiş	yemeğ-i-ymiş	1
yemiyor	ye-mi-yor	2
yemiyorlar	ye-mi-yor-lar	1
yemiyorsun	ye-mi-yor-sun	1
yemiş	yemiş	2
yemişsindir	ye-miş-sin-dir	1
yenge	yenge	1
yengen	yenge-n	3
yeni	yeni	10
yer	yer	47
yerde	yer-de	5
yerdi	yer-di	1
yere	yer-e	15
yeri	yer-i	1
yerim	yer-im	3
yerinde	yer-i-nde	4
yerine	yer-i-ne	10
yerini	yer-i-ni	1
yeriz	yer-iz	1
yerler	yer-ler	11
yerlere	yer-ler-e	2
yerleri	yer-ler-i	71
yerlerimi	yer-ler-im-i	1
yersem	yer-se-m	1
yersen	ye-r-se-n	1
yesin	ye-sin	11
yesinler	ye-sinler	2
yet	yet	1
yeter	yet-er	3
yetiş	yetiş	1
yetişecekler	yetiş-ecek-ler	1
yetişince	yetiş-ince	1
yetişmez	yetiş-me-z	1
yeşil	yeşil	1
yeşim	yeşim	10
yine	yine	8
yirmi	yirmi	2
yirmisi	yirmi-si	1
yiyebilirsin	yi-yebil-ir-sin	1
yiyebiliyor	yi-yebil-iyor	1
yiyecek	yiyecek	4
yiyeceklermiş	yiyecek-ler-miş	1
yiyeceksin	yiyecek-sin	1
yiyeceğiz	yi-yeceğ-iz	1
yiyelim	yi-ye-li-m	2
yiyeyim	yi-ye-yim	1
yiyin	yi-yin	1
yiyince	yi-yince	1
yiyor	yi-yor	10
yiyorlar	yi-yor-lar	4
yiyormuş	yi-yor-muş	2
yiyorsanız	yi-yor-sa-nız	1
yiyorsun	yi-yor-sun	7
yiyoruz	yi-yor-uz	1
yo	yo	1
yok	yok	134
yokmuş	yok-muş	9
yoksa	yok-sa	6
yoktu	yok-tu	1
yoktun	yok-tu-n	1
yokuş	yokuş	1
yol	yol	13
yolda	yol-da	3
yolluyor	yollu-yor	1
yolu	yol-u	1
yolun	yol-un	2
yolunda	yol-u-nda	1
yorgan	yorgan	2
yorganı	yorgan-ı	2
yorganını	yorgan-ı-nı	1
yoruldum	yor-ul-du-m	2
yoruldun	yor-ul-du-n	1
yoruyordu	yor-uyor-du	1
yukarda	yukar-da	1
yukarı	yukarı	3
yukarıda	yukarı-da	1
yukarıdakinde	yukarı-da-ki-n-de	1
yumurta	yumurta	5
yumurtalı	yumurta-lı	1
yusuf	yusuf	1
yuvaları	yuva-lar-ı	1
yuvarlak	yuvarlak	2
yuvarlaklar	yuvarlak-lar	2
yuvası	yuva-sı	1
yüksek	yüksek	5
yünden	yün-den	1
yürüdük	yürü-dü-k	2
yürüdün	yürü-dü-n	1
yürümez	yürü-me-z	1
yürümüyor	yürü-mü-yor	1
yürür	yürü-r	2
yürürken	yürü-r-ken	1
yürürler	yürü-r-ler	2
yürüsün	yürü-sün	1
yürüt	yürüt	2
yürüttün	yürüt-tü-n	1
yürütüyor	yürü-t-üyor	1
yürüyebilirsin	yürü-yebil-ir-sin	1
yürüyebiliyor	yürü-yebil-iyor	2
yürüyebiliyorlar	yürü-yebil-iyor-lar	1
yürüyemiyor	yürü-ye-mi-yor	1
yürüyerek	yürü-yerek	3
yürüyor	yürü-yor	3
yürüyorlar	yürü-yor-lar	4
yüz	yüz	1
yüzdük	yüz-dü-k	2
yüzdüm	yüz-dü-m	2
yüzdün	yüz-dü-n	2
yüzdüğünü	yüz-düğ-ü-nü	1
yüzebilecek	yüz-ebil-ecek	1
yüzebilir	yüz-ebil-ir	3
yüzebiliyor	yüz-ebil-iyor	7
yüzemiyor	yüz-e-mi-yor	1
yüzen	yüz-en	1
yüzer	yüz-er	31
yüzerken	yüz-er-ken	2
yüzerler	yüz-er-ler	9
yüzermiş	yüz-er-miş	1
yüzersin	yüz-er-sin	2
yüzgeç	yüzgeç	1
yüzgeçleri	yüzgeç-ler-i	1
yüzgeçlerin	yüzgeç-ler-in	1
yüzme	yüz-me	2
yüzmek	yüz-mek	1
yüzmesini	yüz-me-si-ni	2
yüzmeye	yüz-me-ye	2
yüzsün	yüz-sün	1
yüzük	yüzük	1
yüzüne	yüz-ü-ne	5
yüzünü	yüz-ü-nü	8
yüzüyor	yüz-üyor	13
yüzüyordun	yüz-üyor-du-n	2
yüzüyorlar	yüz-üyor-lar	2
yüzüyorsun	yüz-üyor-sun	7
yüzüğü	yüzüğ-ü	1
yüzüğün	yüzüğ-ün	2
yüzüğünü	yüzüğ-ü-nü	1
yıkadın	yıka-dı-n	1
yıkamasaydı	yıka-ma-sa-ydı	2
yıkamış	yıka-mış	1
yıkanabiliyor	yıka-n-abil-iyor	1
yıkandılar	yıka-n-dı-lar	1
yıkandın	yık-a-n-dı-n	3
yıkanır	yıka-n-ır	2
yıkanıyorsun	yıka-n-ıyor-sun	1
yıkar	yık-ar	1
yıkarken	yıka-r-ken	1
yıkarsın	yık-ar-sın	1
yıkayabiliyor	yıka-yabil-iyor	1
yıkayabiliyorlar	yıka-yabil-iyor-lar	1
yıkıyor	yık-ıyor	8
yıkıyorsun	yık-ıyor-sun	2
yıkıyorum	yık-ıyor-um	1
yılan	yılan	2
yırtma	yırt-ma	1
yırttı	yırt-tı	2
zaman	zaman	301
zamandı	zaman-dı	2
zamandır	zaman-dır	1
zamanken	zaman-ken	1
zamanlarda	zaman-lar-da	2
zamanında	zaman-ı-nda	2
zannederim	zanned-er-im	1
zannediyordum	zanned-iyor-du-m	1
zannettim	zannet-ti-m	1
zarf	zarf	2
zaten	zaten	9
zavallı	zavallı	2
zebra	zebra	5
zehra	zehra	1
zeliha	zeliha	1
zelihanın	zeliha-nın	1
zeynep	zeynep	5
zeynepe	zeynep-e	1
zeyneple	zeynep-le	7
zeytin	zeytin	1
ziyanı	ziyan-ı	6
ziyaret	ziyaret	1
zombie	zombie	1
zor	zor	5
zormuş	zor-muş	1
zuhal	zuhal	2
zuhale	zuhal-e	1
zuhalle	zuhal-le	1
zühal	zühal	2
zühalciğim	zühal-ciğ-im	1
zürafa	zürafa	3
zıplatıyor	zıpla-t-ıyor	1
çabuk	çabuk	6
çak	çak	2
çakarsın	çakar-sın	1
çalabiliyor	çal-abil-iyor	1
çalacak	çal-acak	3
çalacam	çal-a-ca-m	1
çalar	çal-ar	5
çalayım	çal-a-yım	1
çaldı	çal-dı	2
çaldırdın	çal-dır-dı-n	1
çalmak	çal-mak	1
çalmıyorsun	çal-mı-yor-sun	1
çalmış	çal-mış	1
çalmıştı	çal-mış-tı	1
çalındı	çal-ın-dı	1
çalınmaz	çal-ın-ma-z	1
çalınsın	çal-ın-sın	1
çalınır	çal-ın-ır	1
çalınıyor	çal-ın-ıyor	1
çalıyor	çal-ıyor	6
çalıyım	çalı-yım	1
çalış	çal-ış	1
çalışayım	çalış-a-yım	1
çalışmadı	çalış-ma-dı	1
çalışmıyor	çalış-mı-yor	1
çalışsın	çalış-sın	1
çalıştın	çalış-tı-n	1
çalıştır	çal-ış-tır	2
çalıştıralım	çalış-tır-a-lı-m	1
çalıştırma	çalış-tır-ma	1
çalıştırıyorum	çalış-tır-ıyor-um	1
çalışır	çalış-ır	3
çalışıyor	çalış-ıyor	15
çalışıyorsa	çalış-ıyor-sa	1
çalışıyorum	çalış-ıyor-um	1
çamaşır	çamaşır	3
çamaşırla	çamaşır-la	1
çamaşırlar	çamaşır-lar	1
çamaşırlarımla	çamaşır-lar-ım-la	1
çamaşırı	çamaşır-ı	2
çamur	çamur	1
çan	çan	1
çantamdan	çanta-m-dan	1
çantan	çanta-n	1
çantanın	çanta-nın	1
çarpan	çarp-an	10
çarpanı	çarpan-ı	2
çarpar	çarp-ar	1
çarparsam	çarp-ar-sa-m	1
çarpayım	çarp-a-yım	1
çarpmasın	çarp-ma-sın	1
çarptı	çarp-tı	27
çarptığı	çarp-tığ-ı	2
çarpıyor	çarp-ıyor	3
çarşıda	çarşı-da	1
çarşıdan	çarşı-dan	1
çarşıya	çarşı-ya	2
çatalları	çatal-lar-ı	1
çatısı	çatı-sı	5
çatısından	çatı-sı-ndan	1
çatısını	çatı-sı-nı	1
çatıyorsun	çat-ıyor-sun	1
çay	çay	11
çayan	çayan	1
çayı	çay-ı	1
çayımız	çay-ımız	1
çayını	çay-ı-nı	1
çağır	çağır	1
çağırdın	çağır-dı-n	1
çağırsak	çağır-sa-k	1
çağırsın	çağır-sın	1
çek	çek	3
çekicini	çekic-i-ni	1
çekil	çekil	2
çekilmezsem	çekil-me-z-se-m	8
çekince	çekince	1
çekirdek	çekirdek	1
çekirdeği	çekirdeğ-i	2
çekirdeğini	çekirdeğ-i-ni	2
çekiç	çekiç	2
çekiçle	çekiçle	2
çekme	çekme	1
çekmecesinde	çekmece-si-nde	3
çekmek	çek-mek	1
çekmeyim	çekme-yim	1
çektiği	çek-tiğ-i	1
çevir	çevir	2
çevireyim	çevir-e-yim	1
çevirirsin	çevir-ir-sin	1
çeşitli	çeşit-li	1
çiftetelli	çifte+telli	2
çiftlik	çift-lik	3
çiftlikte	çift-lik-te	1
çiftçi	çift-çi	2
çikolatalı	çikolata-lı	1
çimdikledi	çimdikle-di	1
çimen	çimen	1
çirkin	çirkin	3
çivi	çivi	2
çivisi	çivi-si	1
çizdik	çiz-di-k	1
çizgi	çizgi	1
çiziyor	çiz-iyor	1
çizmesin	çiz-me-sin	1
çiçek	çiçek	9
çiçekler	çiçek-ler	1
çiğ	çiğ	1
çiğniyorsun	çiğni-yor-sun	1
çiş	çiş	2
çişini	çiş-i-ni	2
çocuk	çocuk	38
çocukla	çocuk-la	1
çocuklar	çocuk-lar	128
çocuklara	çocuk-lar-a	2
çocuklarla	çocuk-lar-la	2
çocukları	çocuk-lar-ı	12
çocukların	çocuk-lar-ın	2
çocuksuz	çocuk-suz	1
çocuğa	çocuğ-a	4
çocuğu	çocuğ-u	5
çocuğum	çocuğ-um	27
çocuğun	çocuğ-un	4
çocuğunuz	çocuğ-unuz	1
çok	çok	143
çoktandır	çok-tan-dır	1
çoraplarını	çorap-lar-ı-nı	1
çorba	çorba	5
çorbadan	çorba-dan	1
çorbası	çorba-sı	5
çukulata	çukulata	5
çukulatayı	çukulata-yı	1
çöp	çöp	2
çöpe	çöp-e	1
çözmüşler	çöz-müş-ler	1
çünkü	çünkü	18
çürümesin	çürü-me-sin	1
çık	çık	1
çıkacak	çık-acak	1
çıkamamış	çık-a-ma-mış	1
çıkamaz	çık-a-ma-z	1
çıkamıyorum	çık-a-mı-yor-um	1
çıkar	çıkar	3
çıkarabilirsin	çıkar-abil-ir-sin	1
çıkarabiliyorlar	çık-ar-abil-iyor-lar	1
çıkaracaksın	çıkar-acak-sın	2
çıkaralım	çık-ar-a-lı-m	2
çıkaramıyorum	çık-ar-a-mı-yor-um	2
çıkarayım	çıkar-a-yım	3
çıkardı	çık-ar-dı	1
çıkardın	çık-ar-dı-n	1
çıkarlar	çıkar-lar	1
çıkarma	çıkarma	2
çıkarmıyordun	çık-ar-mı-yor-du-n	2
çıkarmıyorsun	çıkar-mı-yor-sun	1
çıkart	çıkar-t	6
çıkartacağım	çıkar-t-acağ-ım	2
çıkartayım	çık-ar-t-a-yım	2
çıkartma	çıkar-t-ma	2
çıkartmadı	çıkar-t-ma-dı	1
çıkartmak	çık-ar-t-mak	1
çıkartmamak	çıkar-t-ma-mak	2
çıkartmasın	çık-ar-t-ma-sın	1
çıkartmayacak	çık-ar-t-ma-yacak	1
çıkartmıyor	çık-ar-t-mı-yor	1
çıkarttık	çık-ar-t-tı-k	1
çıkarttım	çıkar-t-tı-m	1
çıkarttın	çıkar-t-tı-n	1
çıkartır	çık-ar-t-ır	1
çıkarılır	çık-ar-ıl-ır	1
çıkarırlar	çıkar-ır-lar	1
çıkarıyor	çık-ar-ıyor	8
çıkmaz	çık-ma-z	2
çıkmıyor	çık-mı-yor	3
çıkmış	çık-mış	7
çıkmışlar	çık-mış-lar	1
çıksın	çık-sın	3
çıktı	çık-tı	11
çıktık	çık-tı-k	1
çıktıktan	çık-tık-tan	2
çıktın	çıktı-n	1
çıktığında	çık-tığ-ı-nda	2
çıkınca	çık-ınca	4
çıkıp	çık-ıp	1
çıkıyor	çık-ıyor	17
çıkıyordu	çık-ıyor-du	1
çıkıyorlar	çık-ıyor-lar	1
çıkıyorsun	çık-ıyor-sun	8
çınaraltında	çınar+altı-nda	2
çınarcıkta	çınarcık-ta	3
çınarcıktaki	çınarcık-ta-ki	1
çınarcıktan	çınarcık-tan	1
çınarcığa	çınarcığ-a	1
çıplak	çıplak	1
çırılçıplak	çırılçıplak	1
öbür	öbür	3
öbürü	öbür-ü	2
öksürüyor	öksür-üyor	1
öksürüyorum	öksür-üyor-um	1
öldürdü	öl-dür-dü	2
ölmesin	öl-me-sin	1
ölmüş	öl-müş	1
ölçeceğiz	ölç-eceğ-iz	1
ölçerim	ölç-er-im	1
ölürken	öl-ür-ken	1
ölürler	öl-ür-ler	1
ömer	ömer	1
ömercim	ömer-ci-m	1
ömerciğim	ömer-ciğ-im	1
önce	önce	10
önünde	ön-ü-nde	6
önüne	ön-ü-ne	4
öper	öp-er	1
öpeyim	öp-e-yim	2
öptü	öp-tü	5
öpünce	öp-ünce	1
öpüyor	öp-üyor	1
öpüyorlar	öp-üyor-lar	1
ördek	ördek	5
ördeğin	ördeğ-in	2
ördü	ör-dü	4
örmüş	ör-müş	1
ört	ört	7
örtmüyor	ört-mü-yor	1
örtü	örtü	2
örtüsü	örtü-sü	1
örtüsüne	örtü-sü-ne	1
öteki	öteki	1
ötekiler	öteki-ler	1
ötekisi	ötekisi	1
öyle	öyle	81
öyleyse	öyle-yse	7
özcan	özcan	2
özcanı	özcan-ı	1
özcanın	özcan-ın	1
özledim	özle-di-m	2
özledin	özle-di-n	1
özlem	özlem	10
özlemcim	özlem-ci-m	3
özlemciğim	özlem-ciğ-im	1
özleme	özlem-e	1
özlemi	özlem-i	1
özlemin	özlem-in	1
özler	özle-r	1
özlüyor	özlü-yor	2
öğleden	öğle-den	2
öğlen	öğlen	2
öğlenleyin	öğlenleyin	2
öğrendin	öğren-di-n	1
öğreneyim	öğren-e-yim	1
öğreniyor	öğren-iyor	1
öğretecek	öğret-ecek	1
öğretiyim	öğreti-yim	3
öğretiyor	öğret-iyor	1
öğretmen	öğretmen	6
öğretmene	öğretmen-e	2
öğretmeni	öğretmen-i	2
öğretmenim	öğretmen-im	3
öğretmenin	öğretmen-in	1
öğretmenine	öğretmen-i-ne	1
öğretmenlerini	öğretmen-ler-i-ni	1
öğretmişti	öğret-miş-ti	1
öğretsene	öğret-sene	1
öğretti	öğret-ti	6
üfleyecek	üfle-yecek	1
üfleyeceksin	üfle-yecek-sin	1
ülkü	ülkü	2
üsküdarda	üsküdar-da	1
üst	üst	1
üstelik	üstelik	2
üstlerini	üst-ler-i-ni	1
üstü	üst-ü	1
üstünde	üst-ü-nde	18
üstündeki	üstün-de-ki	3
üstünden	üst-ü-nden	4
üstüne	üst-ü-ne	24
üstünü	üst-ü-nü	2
ütü	ütü	78
ütüle	ütüle	3
ütülemiyorum	ütüle-mi-yor-um	1
ütülenir	ütüle-n-ir	2
ütüler	ütüle-r	19
ütüleri	ütü-ler-i	2
ütülerler	ütüle-r-ler	1
ütülesene	ütüle-sene	1
ütülüyor	ütülü-yor	75
ütülüyorlar	ütülü-yor-lar	4
ütülüyorsun	üt-ül-üyor-sun	4
ütüyü	ütü-yü	8
üzerine	üzer-i-ne	5
üzmüyorsun	üz-mü-yor-sun	1
üzüldüm	üz-ül-dü-m	1
üzülmüş	üz-ül-müş	1
üzülürüm	üzül-ür-üm	1
üzüyor	üz-üyor	2
üç	üç	10
üçte	üç-te	1
üşümesin	üşü-me-sin	1
üşürsün	üşü-r-sün	1
üşüttün	üşü-t-tü-n	1
üşüyecek	üşü-yecek	1
üşüyecekler	üşü-yecek-ler	1
üşüyor	üşü-yor	1
ıslandı	ısla-n-dı	1
ıslatırsın	ısla-t-ır-sın	1
ısırabiliyor	ısır-abil-iyor	1
ısırdım	ısır-dı-m	1
ısırma	ısır-ma	1
ısırmasın	ısır-ma-sın	3
ısırmaya	ısır-ma-ya	1
ısırmaz	ısır-ma-z	2
ısırmış	ısır-mış	3
ısırsın	ısır-sın	3
ısırır	ısır-ır	55
ısırırlar	ısır-ır-lar	8
ısırırmış	ısır-ır-mış	1
ısırırsın	ısır-ır-sın	1
ısırırsınız	ısır-ır-sınız	1
ısırıyor	ısır-ıyor	4
ısırıyormuş	ısır-ıyor-muş	1
ışıkları	ışık-lar-ı	1
şaban	şaban	1
şaka	şaka	8
şakacıktan	şakacıktan	1
şapkaların	şapka-lar-ın	1
şapkalı	şapka-lı	2
şapkan	şapka-n	2
şapkanı	şapka-n-ı	1
şapkanın	şapka-nın	1
şapkası	şapka-sı	3
şapkayı	şapka-yı	1
şarap	şarap	5
şarkı	şarkı	12
şarkıları	şarkı-lar-ı	1
şarkınız	şark-ınız	1
şeker	şeker	9
şekerim	şeker-im	25
şekerpare	şekerpare	1
şemsiye	şemsiye	2
şey	şey	18
şeye	şey-e	3
şeyi	şey-i	3
şeyini	şey-i-ni	3
şeyle	şey-le	2
şeyler	şey-ler	6
şeyleri	şey-ler-i	1
şeylerini	şey-ler-i-ni	1
şimdi	şimdi	193
şişe	şişe	1
şişir	şişir	2
şişireceksin	şişir-ecek-sin	2
şişirelim	şiş-ir-e-li-m	1
şişiriliyor	şişir-il-iyor	2
şişirme	şiş-ir-me	2
şişmanladın	şişmanla-dı-n	2
şoray	şoray	1
şorayın	şoray-ın	1
şu	şu	37
şule	şule	1
şuna	şu-na	2
şunlar	şu-nlar	10
şunları	şu-nlar-ı	3
şunu	şu-nu	6
şunun	şu-nun	1
şuradan	şura-dan	2
şurası	şura-sı	5
şurasına	şura-sı-na	1
şurasını	şura-sı-nı	1
şuraya	şura-ya	11
şurda	şur-da	6
şurdan	şur-dan	2
şurup	şurup	3
şöför	şöför	3
şöförsüz	şöför-süz	1
şöförü	şöför-ü	2
şöyle	şöyle	8
şık	şık	1
şımarık	şımarık	5
